Mm, Mm, Mm, Mm, Mm, Mm, Mm, Mm, Mm, Mm, Mm, Mm, Mm, Mm, Mm, Mm, Mm, Mm, Mm, Mm, Mm, Hhd, Mm, Mm, Mm, Mm, Mm, Mm, Mm, Mm, Mm, Gg, Mm, Hhd, Mm, Hhd, Hhd
Mm, Mm, Mm, Mm, Mm, Mm, Mm, Mm, Mm, Mm, Mm, Mm, Mm, Mm, Mm, Mm, Mm, Mm, Mm, Mm, Mm, Mm, Hhd, Mm, Hhd, Mm, Mm, Mm, Mm, Mm, Mm, Mm, Mm, Mm, Mm, Mm, Mm
Mm, Mm, Mm, Mm, Mm, Mm, Mm, Mm, Mm, Mm, Mm, Mm, Mm, Mm, Hhd, Hhd, Hhd^Vo, Hhd, Hhd, Mm, Hhd, Mm, Mm, Hhd, Hhd, Hhd^Vo, Mm, Mm, Mm, Mm, Mm, Mm, Mm, Mm, Mm, Mm, Mm
Hhd, Hhd, Hhd, Mm, Mm, Mm, Mm, Mm, Mm, Mm, Mm, Mm, Mm, Mm, Mm, Hhd, Mm, Hhd, Hhd, Hhd, Hhd, Mm, Hhd, Hhd, Hhd, Mm, Mm, Mm, Mm, Mm, Mm, Mm, Mm, Mm, Mm, Mm, Mm
Hhd, Hhd, Hhd, Mm, Mm, Mm, Mm, Mm, Mm, Mm, Mm, Mm, Mm, Mm, Mm, Mm, Mm, Mm, Hhd, Hhd, Hhd, Hhd, Mm, Hhd, Mm, Hhd, Hhd, Mm, Mm, Mm, Mm, Mm, Hhd, Hhd^Vo, Mm, Mm, Mm
Hhd, Hhd, Hhd, Mm, Mm, Mm, Mm, Mm, Co, Hhd, Hhd, Hhd^Vo, Hhd, Mm, Mm, Mm, Mm, Hhd, Hhd, Ss, Ss, Hhd, Mm, Mm, Hhd, Mm, Hhd^Fp, Mm, Mm, Mm, Mm, Mm, Hhd, Hhd, Hhd, Mm, Mm
Hhd, Hhd, Mm, Mm, Mm, Mm, Co, Co, Co, Re, Hhd, Hhd, Hhd, Hhd, Mm, Mm, Hhd, Mm, Ss, Ss, Rb^Em, Ss, Mm, Hhd^Fp, Gll^Fp, Gll^Fmw, Gll^Fmw, Hhd, Mm, Mm, Hhd, Hhd, Hhd, Hhd, Mm, Mm, Mm
Hhd, Hhd, Hhd, Hhd, Co, Co, Co, 2 Ko, Co, Re, Re^Vo, Re, Ss, Hhd^Vo, Mm, Mm, Hhd^Vo, Ss, Ss, Ss, Rb, Ss, Gll^Fp, Hhd, Gll^Fp, Gll^Fp, Gll^Fp, Hhd^Fp, Re, Hhd, Re, Hhd, Hhd, Mm, Mm, Mm, Mm
Hhd, Hhd, Hhd, Hhd, Re, Rb, Rb, Co, Rb, Rb^Es, Rb^Es, Rb, Rb, Ss, Ss, Ss, Ss, Ss, Rb, Rb, Rb, Ss, Gll^Fp, Hhd^Fp, Gll^Fp, Rb, Rb, Rb, Rb, Re, Re, Hhd^Vo, Hhd, Hhd, Mm, Mm, Mm
Hhd, Hhd, Hhd, Re, Rb^Es, Rb^Es, Rb^Vo, Rb, Rb^Es, Rb^Es, Rb^Es, Rb^Es, Ss, Ss, Ss, Ss, Hhd, Hhd, Ss, Rb, Rb, Rb, Rb, Gll^Fp, Rb, Rb^Es, Co, Co, Co, Rb, Rb, Re, Hhd, Hhd, Mm, Mm, Mm
Rb, Hhd, Hhd, Re, Re^Es, Rb^Es, Re, Rb, Ss, Rb, Rb, Rb, Ss^Bw\r, Ss, Ss, Hhd, Hhd, Hhd, Ss, Rb, Ss, Ss, Rb, Rb, Rb^Vo, Rb, Co, 1 Ko, Co, Rb, Re, Re, Mm, Mm, Mm, Mm, Mm
Rb, Hhd, Hhd, Hhd, Re^Vo, Re^Es, Hhd, Ss, Gll^Fp, Gll^Fp, Ss, Ss, Ss, Rb, Rb, Rb, Rb, Rb, Ss, Ss, Ss, Gll^Fp, Rb, Rb^Es, Rb^Es, Rb^Es, Rb, Co, Rb, Rb, Re, Hhd, Mm, Mm, Mm, Mm, Hhd
Rb, Hhd, Hhd, Hhd, Hhd, Hhd, Hhd^Fp, Gll^Fp, Gll^Fp, Gll^Fmw, Ss, Rb^Em, Rb, Rb, Hhd^Vo, Hhd, Re, Rb, Gll^Fp, Gll^Fp, Gll^Fmw, Gll^Fp, Rb^Es, Rb^Es, Rb^Es, Rb^Es, Rb^Es, Rb, Re, Re, Hhd, Hhd^Vo, Md, Md, Mm, Mm, Hhd
Hhd, Hhd, Hhd, Hhd^Fp, Hhd, Hhd^Fp, Hhd, Ss, Gll^Fmw, Gll^Fp, Ss, Rb, Rb, Rb, Hhd, Hhd, Hhd, Re, Re, Gll^Fp, Rb, Rb, Re, Re, Re, Rb^Es, Re, Re^Es, Hhd, Hhd, Mm, Mm, Md, Mm, Mm, Hhd, Hhd
Hhd, Hhd, Ss, Hhd, Ss, Hhd, Hhd, Hhd^Fp, Gll^Fp, Ss, Rb^Em, Ss, Rb, Hhd, Hhd, Hhd, Hhd, Hhd, Re, Re, Re, Re, Hhd, Hhd, Re, Re, Hhd, Re, Hhd, Hhd, Hhd, Hhd, Mm, Mm, Hhd, Hhd, Ww
Ss, Ss, Ss, Ss, Ss, Ss, Rb^Vhs, Gll^Fp, Ss, Ss, Rb^Em, Rb, Hhd, Hhd, Hhd, Hhd^Fp, Gll^Fp, Gll^Fp, Re, Re, Hhd, Hhd, Hhd, Hhd, Hhd, Hhd, Mm, Hhd, Hhd, Hhd, Hhd, Hhd^Vo, Mm, Hhd, Ds, Ds, Ww
Ss, Ss, Rb^Em, Rb, Rb, Rb^Em, Rb^Em, Ss, Ss, Rb, Rb, Rb, Hhd, Hhd^Fp, Gll^Fp, Hhd^Fp, Gll^Fp, Re, Re, Hhd, Hhd, Hhd, Hhd, Hhd, Mm, Mm, Hhd^Vo, Hhd, Hhd, Hhd, Hhd, Mm, Hhd, Hhd, Ds, Ww, Ww
Ss, Ss, Ss, Ss, Rb^Em, Rb, Rb, Ss, Rb, Ss, Rb, Hhd, Hhd, Re^Es, Re, Gll^Fp, Rb, Re, Hhd, Hhd, Mm, Hhd, Hhd, Mm, Hhd, Mm, Hhd, Hhd, Ss, Hhd, Hhd, Mm, Ss, Ss, Ss, Ww, Ww
Hhd, Hhd, Hhd, Hhd, Rb, Rb, Ss, Rb, Rb, Ss, Rb, Hhd, Re^Es, Re^Es, Rb^Es, Rb, Rb^Es, Re, Hhd, Mm, Hhd, Hhd, Ss, Hhd, Hhd, Mm, Hhd, Ss, Rb, Ss, Ss, Hhd, Ss, Ss, Ss, Ww, Ww
Mm, Hhd, Mm, Hhd, Hhd, Hhd, Ss, Ss, Rb, Rb, Rb^Es, Rb, Rb^Es, Rb^Es, Rb, Rb^Es, Re, Re, Hhd, Mm, Hhd^Vo, Ss, Ss, Hhd, Hhd, Hhd, Ss, Ss, Rb, Rb, Rb, Ss, Rb, Rb, Ss, Ww, Ww
Hhd, Mm, Mm, Mm, Hhd^Vo, Hhd, Hhd, Hhd, Ss, Rb, Rb, Rb, Rb, Rb, Rb, Re, Hhd, Hhd, Mm, Mm, Hhd, Ss, Ss, Ss, Ss, Ss, Ss, Rb, Rb, Rb, Rb, Rb, Gll^Fp, Gll^Fp, Gll^Fp, Ww, Ww
Hhd, Hhd, Hhd, Hhd, Hhd, Hhd, Hhd, Hhd, Hhd, Ss, Hhd, Gll^Fp, Gll^Fp, Gll^Fp, Rb, Re, Re, Hhd, Mm, Mm, Hhd, Hhd, Ss, Ss, Ss, Ss, Ss, Rb, Ss, Ss, Gll^Fp, Rb, Gll^Fmw, Gll^Fp, Gll^Fp, Ww, Ww
Gg, Hhd, Gs, Hhd, Hhd, Hhd, Hhd, Mm, Hhd, Hhd, Hhd^Vo, Hhd^Fp, Gll^Fmw, Gll^Fp, Gll^Fp, Rb, Re, Hhd, Hhd, Hhd, Hhd, Re, Rb, Rb, Rb, Ss, Gll^Fp, Ss, Gll^Fp, Ss, Ss, Rb^Vhs, Gll^Fp, Gll^Fp, Gll^Fp, Ww, Ww
Gs, Gs, Gs, Gs, Gs, Hhd, Hhd^Vo, Mm, Mm, Hhd, Hhd^Fp, Gll^Fp, Gll^Fp, Gll^Fp, Rb, Rb, Re, Re^Vo, Hhd, Hhd, Hhd, Re, Re, Rb, Gll^Fp, Gll^Fp, Hhd^Fp, Gll^Fp, Gll^Fmw, Gll^Fp, Gll^Fp, Rb, Gll^Fmw, Gll^Fp, Gll^Fp, Ww, Ww
Gg, Gg, Gs, Gs, Gs, Hhd, Hhd, Mm, Mm, Hhd, Hhd, Gll^Fp, Gll^Fp, Gll^Fp, Rb^Es, Re, Hhd, Hhd, Hhd, Hhd, Hhd, Hhd, Rb, Rb^Vo, Gll^Fp, Gll^Fmw, Hhd, Gll^Fp, Gll^Fp, Gll^Fp, Rb, Rb, Gll^Fp, Gll^Fp, Ds, Ww, Ww
Gg, Gs, Gg, Gg, Gg, Hhd, Hhd, Hhd, Hhd, Hhd, Rb, Gll^Fp, Gll^Fp, Rb, Rb, Re, Re^Es, Re^Es, Re, Re, Ss, Ss, Rb, Gll^Fp, Gll^Fp, Gll^Fmw, Hhd, Hhd, Hhd, Hhd, Rb, Gll^Vo, Gll^Fp, Gll^Fp, Ds, Ww, Ww
Gg, Gg, Gg, Gg, Gg, Gg, Gg, Hhd, Hhd^Vo, Hhd, Re, Rb, Rb, Rb, Rb, Rb^Es, Rb^Es, Rb, Rb, Rb, Rb^Vhs, Ss, Ss, Rb, Gll^Fp, Gll^Fp, Hhd, Mm, Mm, Mm, Rb, Gll^Fp, Gll^Fp, Ds, Ww, Ww, Wo
Gs^Fds, Gs^Fds, Gg, Gg, Gg, Gg, Gg, Hhd, Hhd, Hhd, Hhd, Re, Re, Re, Rb, Rb, Rb, Rb, Ss, Ss, Rb, Rb, Ss, Hhd^Vo, Hhd^Fp, Gll^Fp, Hhd, Mm, Hhd^Vo, Hhd, Rb, Hhd^Fp, Hhd, Ds, Ww, Ww, Wo
Gs^Fds, Gg, Gs^Fds, Gs^Fds, Gs^Fds, Gg, Gg, Gs, Hhd, Hhd, Hhd, Re, Re, Re, Re, Re, Hhd, Ss, Ss, Rb, Rb, Ss, Rb, Hhd, Hhd, Hhd, Hhd, Mm, Hhd, Hhd, Co, Hhd, Hhd, Ds, Ww, Ww, Wo
Gs^Fds, Gg, Gg, Gs^Fds, Gs^Fds, Gg, Gs, Gs, Gs, Hhd, Re, Re, Re, Hhd, Hhd, Re, Hhd, Hhd, Hhd, Hhd, Hhd, Rb, Hhd, Hhd, Hhd, Hhd, Hhd, Hhd, Hhd, Hhd, Co, Hhd, Re, Ww, Ww, Ww, Wo
Gs^Fds, Gs^Fds, Gs^Fds, Gg, Gg, Gg, Gg, Gg, Gg, Gs, Re, Re, Re, Hhd, Hhd^Vo, Hhd, Hhd, Hhd, Mm, Hhd, Mm, Hhd, Hhd^Fp, Hhd, Hhd, Hhd, Re, Co, Co, 3 Ko, Re, Re, Ww^Bw\, Ww, Ww, Wo, Wo
Gs^Fds, Gs^Fds, Gs^Fds, Gg, Gg, Gg, Gg, Gg, Re, Re, Gs, Re, Hhd, Hhd, Hhd, Hhd, Hhd, Mm, Mm, Mm, Mm, Mm, Hhd, Hhd, Hhd^Fp, Gll^Fp, Rb^Vo, Re^Es, Rb^Es, Re, Rb, Rb, Ww^Bw\, Ww, Wo, Wo, Wo
Gs^Fds, Gs^Fds, Gs^Fds, Gs^Fds, Gg, Gs^Fds, Gg, Gg, Re, Gs, Gs, Gs, Gs, Hhd, Gs, Hhd, Hhd, Hhd, Hhd, Hhd, Hhd^Vo, Hhd, Gll^Fp, Hhd, Hhd, Gll^Fp, Gll^Fp, Rb^Es, Rb^Es, Rb, Ww, Ww^Bw\, Ww, Ww, Wo, Wo, Wo
Gs^Fds, Gs^Fds, Gg, Gg, Gg, Gg, Re, Re, Gg, Gg, Gs, Gs, Gs, Gs, Hhd, Hhd, Gs, Hhd, Gs, Hhd, Gll^Fp, Gll^Fp, Gll^Fp, Gll^Fmw, Gll^Vo, Gll^Fmw, Gll^Fp, Rb, Rb, Rb, Ww, Ww, Ww, Wo, Wo, Wo, Wo
Gg, Gg, Gg, Gg, Re, Re, Gg, Gg, Gg^Fds, Gg^Fds, Gs, Gs, Gg, Gg, Gg, Gg, Gs, Gs, Gs, Gs, Re, Re, Gll^Fp, Gll^Fp, Gll^Fp, Gll^Fmw, Rb, Rb, Ds, Ww, Ww, Ww, Wo, Wo, Wo, Wo, Wo
Re, 4 Re, Re, Re, Gg^Fds, Gg, Gs^Fds, Hh^Fds, Hh^Fds, Hh, Hh^Fds, Hh, Gg, Gg, Gg, Gg, Gg, Gg, Gg, Gs, Re, Re, Gll^Fp, Gll^Fmw, Rb, Gll^Fp, Rb, Ds, Ww, Ww, Ww, Ww, Wo, Wo, Wo, Wo, Wo
Gg, Gg, Gg, Gg^Fds, Gg^Fds, Hh, Hh, Hh, Hh, Hh, Hh, Hh, Hh, Gg, Gg, Gg, Gg, Gg, Gg, Re, Re, Re, Re, Re, Rb, Rb, Ds, Ds, Ww, Ww, Ww, Wo, Wo, Wo, Wo, Wo, Wo
