Gs, Gg, Hh, Hh, Hh, Hh, Hh, Hh, Hh, Hh, Hh, Hh, Hh^Fds, Hh, Hh^Fds, Hh, Hh, Hh, Hh, Hh, Hh, Hh, Hh, Hh, Hh^Fds, Gg, Gll^Fds, Gll^Fds, Gll^Fds, Gg^Fds, Hh^Fds, Hh, Hh, Hh, Hh, Hh, Hh, Hh, Hh, Hh, Hh, Gg, Gg, Gg, Gg, Gg, Gg, Gg, Gg, Gg^Edt, Rr, Gg, Gg, Re^Edt, Gg, Gs^Fds, Gs^Fms, Gll^Fms, Gs^Fds, Gs^Fds, Gs^Fds, Gs^Fds
Gs, Hh, Gs, Hh, Gs, Hh, Hh, Hh, Hh, Hh, Hh, Gg, Gg, Gll^Fds, Gll^Fds, Hh^Fds, Gs, Hh, Hh, Hh, Hh, Gll^Fds, Hh, Hh^Fds, Hh, Hh^Fds, Gll^Fds, Gll^Fds, Gll^Fds, Hh^Fds, Gs, Hh, Hh, Hh, Gg, Hh, Gg, Hh, Gg, Hh, Gg, Gg, Gg, Gg, Gg, Gg, Re^Vct, Gg, Gs, Gg, Rr, Gg, Re^Vct, Gg, Gg^Fms, Gs^Fds, Gll^Fms, Gs^Fds, Gs^Fds, Gs^Fds, Gs^Fds, Gs^Fds
Gs, Gs, Gs, Gs, Gs, Gs, Gs, Gg, Gg, Hh, Gg, Hh, Gg, Gg, Gg, Hh, Gg, Gs, Gs, Hh, Gs, Gs, Hh, Hh, Hh, Hh, Hh, Gs^Fms, Gs, Hh, Hh, Gs, Gs, Gg, Gg, Gg, Gs^Fds, Gg, Gs^Fds, Gg, Gs^Fds, Gg, Gg, Gg, Re, Re^Vct, Re^Ecf, Re, Re^Vct, Gg, Rr, Re, Gs, Gs, Gs^Fms, Gs^Fds, Gg, Gg, Gs^Fds, Gs^Fds, Gs^Fds, Gs^Fds
Gs^Fds, Hh, Gs^Fds, Hh, Gg, Gg, Gs^Fds, Gg, Gg, Gg, Gg, Gg, Gg, Gg, Gs, Gg, Gg, Gg, Gll^Fds, Gs, Hh^Fds, Gs, Hh, Hh, Hh, Hh, Gs, Hh, Hh, Hh, Re, Gs, Re, Gs, Gg, Gg, Gg, Gs^Fms, Gs^Fms, Gs^Fds, Gg, Gs^Fds, Gg, Re^Vct, Re^Vct, Re, Re, Re^Vct, Rr, Rr, Ce, Ce, 2 Ke, Gs, Gg, Gg, Gg, Gs^Vl, Gs^Fds, Gs^Fds, Gs^Fds, Gs^Fds
Hh^Fds, Gs^Fds, Gll^Fds, Hh, Gg, Gs^Fds, Gll^Fds, Hh^Fds, Hh, Hh, Gg, Gg, Gs, Gs, Gs, Gs, Gg, Gg, Hh, Hh^Fds, Hh, Hh, Hh, Hh, Hh, Gs, Gs, Hh, Re, Re, Rb^Gvs, Re, Re^Vhr, Re, Gg, Gg, Gg, Gs^Fms, Gg, Gs^Vl, Gg, Gg, Gg, Gs, Gs, Re^Vct, Rr, Rr, Re, Ce, Re^Ecf, Ce, Ce, Ce, Re, Gg, Gs^Fds, Gg^Fds, Gg^Fms, Gs^Fds, Gs^Fds, Gs^Fds
Gg, Gg, Gg, Gg, Hh, Hh^Fds, Hh^Fds, Hh^Fds, Hh, Gg, Gg, Gs, Gg, Gs, Gg, Gg, Re^Eff, Re, Re, Re, Re, Re, Re, Re, Re, Re, Re, Re, Rb^Gvs, Rb^Gvs, Rb^Gvs, Rb^Gvs, Rb^Gvs, Re, Re, Gg, Gg, Gg, Gg, Gg, Gg, Gg, Gg, Gg, Rr, Rr, Re, Re^Vct, Re^Vct, Re, Re, Ce, Gg, Gg, Re^Vct, Re^Vct, Gs^Fds, Gs^Fds, Gs^Fds, Gg^Fms, Rb^Gvs, Gs^Fds
Re, Re, Re, Re, Re, Gs, Gs, Hh, Gs, Hh, Gg, Gg, Gs, Gs, Re^Eff, Re^Eff, Rb^Gvs, Rb^Gvs, Rb^Gvs, Rb^Gvs, Rb^Gvs, Rb^Gvs, Ch^Qhux, Re, Rb^Gvs, Rb^Gvs, Rb^Gvs, Rb^Gvs, Rb^Gvs, Rb^Gvs, Rb^Gvs, Rb^Gvs, Rb^Gvs, Rb^Gvs, Ch^Qhux, Re, Re, Gg, Gg, Gg, Gg, Gg, Rr, Rr, Gs^Eff, Gs^Eff, Gs^Eff, Gg, Gg, Gs, Gg, Re, Re, Gg, Gg, Gg, Gs^Eff, Gll^Fms, Rb^Gvs, Rb^Gvs, Rb^Gvs, Rb^Gvs
Gg, Gg, Hh, Gg, Gg, Re, Re, Gs, Re, Hh, Hh, Gs, Re^Eff, Re^Vhr, Rb^Gvs, Rb^Gvs, Rb^Gvs, Rb^Gvs, Rb^Gvs, Rb^Gvs, Ch^Qhux, Ch^Qhux, Rb, Ch^Qhux, Ch^Qhux, Rb^Gvs, Rb^Gvs, Rb^Gvs, Rb^Gvs, Rb^Gvs, Rb^Gvs, Rb^Gvs, Ch^Qhux, Ch^Qhux, Rb^Dr, Ch^Qhux, Xos, Re, Re, Gg, Rr, Rr, Gs^Eff, Gs^Eff, Rb^Gvs, Rb^Gvs, Rb^Gvs, Gs^Eff, Gs^Eff, Gs^Eff, Gs^Eff, Gg, Gg, Re, Re, Gs^Eff, Rb^Gvs, Rb^Gvs, Rb^Gvs, Rb^Gvs, Rb^Gvs, Rb^Gvs
Hh, Hh, Hh^Fds, Gs, Hh, Gg, Gg, Re, Gg, Re, Re, Re^Eff, Rb^Gvs, Rb^Gvs, Rb^Gvs, Rb^Gvs, Rb^Gvs, Rb^Gvs, Ch^Qhux, Ch^Qhux, Rb, Rb, Rb^Dr, Rb, Rb^Dr, Ch^Qhux, Ch^Qhux, Rb^Gvs, Rb^Gvs, Rb^Gvs, Ch^Qhux, Ch^Qhux, Re^Es, Rb^Dr, Rb^Dr, Re^Es, Rb^Dr, Rr^Pr\, Rr^Pr\, Rr, Gs, Gs^Eff, Rb^Gvs, Rb^Gvs, Rb^Gvs, Rb^Gvs, Rb^Gvs, Rb^Gvs, Rb^Gvs, Rb^Gvs, Rb^Gvs, Gs^Eff, Gs^Eff, Gs^Eff, Rb^Gvs, Re, Re, Rb^Gvs, Rb^Gvs, Rb^Gvs, Rb^Gvs, Rb^Gvs
Hh, Hh^Fds, Hh^Fds, Hh, Hh, Gs, Gs, Gg, Gg^Eff, Gg^Eff, Re, Re, Rb^Gvs, Rb^Gvs, Rb^Gvs, Rb^Gvs, Ch^Qhux, Ch^Qhux, Rb^Es, Rb^Es, Rb^Es, Rb, Rp^Vhr, Rb^Dr, Ch, Rb^Dr, Rb^Dr, Ch^Qhux, Ch^Qhux, Ch^Qhux, Rb^Dr, Rb^Dr, Re^Es, Re^Es, Chr, Rb^Dr, Rr, Rr, Re, Rr^Pr\, Xos, Rb^Gvs, Rb^Gvs, Rb^Gvs, Rb^Gvs, Rb^Gvs, Rb^Gvs, Rb^Gvs, Rb^Gvs, Rb^Gvs, Rb^Gvs, Rb^Gvs, Rb^Gvs, Rb^Gvs, Rb^Gvs, Rb^Gvs, Rb^Gvs, Re^Vhr, Rb^Gvs, Rb^Gvs, Rb^Gvs, Rb^Gvs
Hh, Hh, Gs, Hh, Gs, Gs, Gs, Re^Vhr, Rb^Gvs, Rb^Gvs, Mm, Re, Re, Rb^Gvs, Ch^Qhux, Ch^Qhux, Isa, Isa, Isa, Isa, Isa, Rb^Dr, Rb^Dr, Ch, Rb^Dr, Rb^Es, Rb^Dr, Rb^Dr, Rb, Rb, Chr, Rb^Dr, Chr, Re^Es, Rr, Rr, Rb^Dr, Rb^Dr, Rb^Es, Re, Rb^Dr, Ch^Qhux, Ch^Qhux, Rb^Gvs, Rb^Gvs, Rb^Gvs, Ch^Qhux, Ch^Qhux, Ch^Qhux, Rb^Gvs, Rb^Gvs, Rb^Gvs, Rb^Gvs, Rb^Gvs, Gs^Fds, Rb^Gvs, Rb^Gvs, Re, Rb^Gvs, Rb^Gvs, Rb^Gvs, Rb^Gvs
Gg, Gg, Gg, Gs, Gll^Fms, Gs, Gs^Fds, Rb^Gvs, Rb^Gvs, Rb^Gvs, Rb^Gvs, Rb^Gvs, Re, Ch^Qhux, Isa, Isa, Kh, Ch, Ch, Ch, Isa, Ch, Rb^Dr, Rb, Rp^Vhcr, Rb^Es, Rr, Chr, Rb^Dr, Rp^Vhhr, Rb^Dr, Chr, Rr, Rr^Es, Rb^Dr, Rr^Vhc, Rb^Dr, Rb^Es, Rr^Es, Rp^Vhcr, Ch, Rb^Dr, Rb^Dr, Ch^Qhux, Ch^Qhux, Ch^Qhux, Rb^Dr, Rb^Dr, Isa, Ch^Qhux, Ch^Qhux, Rb^Gvs, Rb^Gvs, Gs^Fds, Rb^Gvs, Rb^Gvs, Rb^Gvs, Re^Edt, Rb^Gvs, Rb^Gvs, Gs^Fds, Gs^Fds
Gg, Gg, Gs^Fds, Gs^Fds, Gs^Fds, Gs^Fds, Gs^Fds, Rb^Gvs, Rb^Gvs, Rb^Gvs, Rb^Gvs, Rb^Gvs, Gg, Ch^Qhux, Isa, Kh, 7 Kh, Kh, Ch, Isa, Isa, Ch, Rp^Vhcr, Rb^Dr, Rr, Rr^Es, Rb^Edt, Rr, Rb^Dr, Rb^Dr, Rr, Rr, Rr, Rr, Rr, Rb^Dr, Rb^Dr, Rb^Es, Rr^Es, Rb^Dr, Chr, Chr, Rp^Vh, Rb^Dr, Re^Es, Isa^Es, Ch, Ch, Ch, Isa, Ch^Qhux, Rb^Gvs, Rb^Gvs, Rb^Gvs, Rb^Gvs, Rb^Gvs, Rb^Gvs, Re, Gs^Fds, Gs^Fms, Gs^Fds, Gs^Fds
Gg, Gg, Gg, Gg^Fms, Gs^Fds, Gll^Fms, Rb^Gvs, Rb^Gvs, Rb^Gvs, Rb^Gvs, Rb^Gvs, Rb^Gvs, Gg, Ch^Qhux, Isa, Kh, Kh, Ch, Ch, Ch, Isa, Isa, Rr, Rr, Ch, Rb^Dr, Rb^Dr, Rb^Dr, Rb^Dr, Rr^Es, Rb^Dr, Rp^Vhcr, Rr, Rb^Dr, Rb^Dr, Rr, Rr^Es, Rr^Es, Rb^Es, Rr^Dr, Rr, Rr, Rb^Dr, Re^Es, Isa^Es, Isa^Es, Ch, 6 Kh, Chr, Isa, Ch^Qhux, Rb^Gvs, Rb^Gvs, Rb^Gvs, Rb^Gvs, Rb^Gvs, Rb^Gvs, Re, Gs^Efm, Gs^Fds, Gs^Fms, Gs^Fms
Gg, Gg, Gg, Hh, Hh, Hh, Hh, Rb^Gvs, Hh, Rb^Gvs, Gs^Fds, Gg, Gg, Ch^Qhux, Rb, Isa, Ch, Ch, Ch, Isa^Qhh, Rr, Rr, Rb^Dr, Rb^Dr, Rb^Dr, Rb^Es, Chr^Edt, Rp^Vhcr, Rb^Dr, Rb^Es, Rb^Es, Rb^Dr, Rr, Rb^Dr, Re^Es, Rb^Dr, Rr, Rb^Dr, Rb^Dr, Rb^Es, Rb^Es, Rb^Dr, Rr^Vhc, Re^Es, Rr, Ch, Isa^Es, Chr, Rb^Dr, Rb^Dr, Ch^Qhux, Rb^Gvs, Rb^Gvs, Rb^Gvs, Rb^Gvs, Rb^Gvs, Rb^Gvs, Re^Vhr, Gs^Fds, Gs^Fds, Rb^Gvs, Rb^Gvs
Gs^Fds, Gs^Fds, Hh, Hh, Hh, Hh^Fds, Hh, Hh, Gg, Gs^Fms, Gg, Gg, Ch^Qhux, Ch^Qhux, Rb^Dr, Isa, Ch, Isa, Isa, Isa, Rb^Dr, Rr, Rr, Rb^Es, Rb^Dr, Rb^Es, Chr^Edt, Khr, Ch, Rb^Dr, Rb^Dr, Ch, Rr, Rb, Re^Es, Rr, Ch, Khr, Rb^Dr, Rb^Dr, Rb^Dr, Rb, Rr, Rr, Rb^Es, Rb^Dr, Isa^Es, Rb^Dr, Rp^Vhcr, Rb^Dr, Ch^Qhux, Rb^Gvs, Rb^Gvs, Rb^Gvs, Rb^Gvs, Rb^Gvs, Rb^Gvs, Re, Rb^Gvs, Rb^Gvs, Rb^Gvs, Rb^Gvs
Gg, Gs^Fds, Gg, Hh, Gs^Fds, Hh, Gs^Fds, Hh, Rb^Gvs, Gg, Gg, Ch^Qhux, Rb^Dr, Rb^Dr, Re^Es, Isa, Isa, Isa, Rb^Dr, Rp^Vhcr, Rb^Dr, Rp^Vhcr, Rr, Rr, Rr, Rp^Vhcr, Rb^Dr, Re^Es, Re^Es, Rb^Dr, Rb^Dr, Chr, Rr, Rb^Dr, Rb^Dr, Rr, Ch, Chr, Rb^Dr, Rp^Vhcr, Rr, Rr, Rb^Dr, Rb^Es, Chr^Edt, Rb^Es, Chr^Edt, Rb^Dr, Rb^Dr, Rb^Dr, Ch^Qhux, Rb^Gvs, Rb^Gvs, Rb^Gvs, Rb^Gvs, Rb^Gvs, Rb^Gvs, Re^Edt, Re^Edt, Rb^Gvs, Rb^Gvs, Rb^Gvs
Gg, Gg, Gg, Gg, Gg, Gg, Gg, Gs^Fds, Rb^Gvs, Rb^Gvs, Rb^Gvs, Ch^Qhux, Rb^Dr, Re^Es, Rb^Dr, Rb, Rb^Dr, Rb^Es, Rp^Vhcr, Rb^Dr, Rr, Rr, Rp^Vhhr, Rb^Dr, Rb^Dr, Rb^Dr, Rr^Es, Re^Es, Re^Es, Rb^Dr, Rp^Vhcr, Rb^Dr, Rr, Rb^Dr, Rr^Vhc, Rb, Rb^Es, Rb^Es, Rr, Rr^Dr, Rr^Dr, Rb^Dr, Rb^Es, Rb^Es, Rb^Es, Chr^Edt, Rr, Rr, Rb^Es, Rb^Dr, Rb^Dr, Ch^Qhux, Ch^Qhux, Rb^Gvs, Rb^Gvs, Rb^Gvs, Rb^Gvs, Rb^Gvs, Rb^Gvs, Re, Rb^Gvs, Rb^Gvs
Rb^Gvs, Rb^Gvs, Rb^Gvs, Rb^Gvs, Rb^Gvs, Re, Gs^Fds, Gg, Rb^Gvs, Rb^Gvs, Rb^Gvs, Ch^Qhux, Rb^Es, Rp^Vhcr, Rb^Es, Rb, Rb^Dr, Rb, Rb^Dr, Rr, Rb, Rb^Dr, Rb^Dr, Re^Es, Rb, Rb^Dr, Isa^Es, Rr^Es, Rr, Rb^Dr, Rb^Dr, Rb^Dr, Rr, Rb, Rb^Dr, Rb^Dr, Rr, Rr, Re^Es, Rb^Dr, Rb^Es, Rr, Rb^Dr, Rb^Es, Rb^Dr, Chr^Edt, Rr, Rb^Dr, Rb^Dr, Rb^Es, Rb^Es, Rb, Ch^Qhux, Rb^Gvs, Rb^Gvs, Rb^Gvs, Rb^Gvs, Rb^Gvs, Rb^Gvs, Re, Re, Gg
Rb^Gvs, Rb^Gvs, Rb^Gvs, Rb^Gvs, Rb^Gvs, Gs^Fds, Gs^Fds, Rb^Gvs, Rb^Gvs, Rb^Gvs, Rb^Gvs, Ch^Qhux, Rb^Dr, Rb^Es, Rb^Es, Ch, Ch, Rb^Dr, Rp^Vhcr, Rb^Dr, Rb^Dr, Re^Es, Re^Es, Re^Es, Khr, Rb^Dr, Rb^Dr, Rb^Dr, Rb, Rr, Rr, Rr, Rr^Es, Rr, Rr, Rr, Rb^Dr, Ch, Rb^Dr, Rb^Dr, Rb^Es, Rr, Rr, Rp^Vhcr, Rr, Rr, Rb^Dr, Rr, Rr, Rb^Es, Rb^Es, Rb^Dr, Ch^Qhux, Rb^Gvs, Rb^Gvs, Rb^Gvs, Rb^Gvs, Rb^Gvs, Gs^Eff, Gs^Eff, Re, Gg
Rb^Gvs, Rb^Gvs, Rb^Gvs, Rb^Gvs, Rb^Gvs, Rb^Gvs, Rb^Gvs, Rb^Gvs, Rb^Gvs, Rb^Gvs, Re, Ch^Qhux, Rb^Dr, Rp^Vhcr, Rb^Es, Khr, Rb^Es, Rb^Dr, Re, Rr, Rb^Dr, Re^Es, Rb, Rb^Dr, Ch, Ch, Rb, Chr^Edt, Rp^Vhcr, Rb^Dr, Rr^Es, Rr^Es, 1 Rr, Rr, Rr, Rb^Dr, Rp^Vhcr, Rb^Es, Rb^Es, Rb^Dr, Rb^Dr, Rb^Dr, Re, Rr, Re, Rb^Dr, Khr, Rb^Dr, Rr^Dr, Rp^Vh, Rb^Es, Rb^Dr, Ch^Qhux, Rb^Gvs, Rb^Gvs, Rb^Gvs, Gs^Fds, Gs^Fds, Gs^Fds, Gs^Fds, Ww, Gg
Rb^Gvs, Rb^Gvs, Rb^Gvs, Rb^Gvs, Rb^Gvs, Rb^Gvs, Rb^Gvs, Rb^Gvs, Gs^Eff, Gs^Eff, Gg, Ch^Qhux, Ch^Qhux, Rb^Dr, Rb^Dr, Ch, Rb^Dr, Rb^Es, Re, Rr, Rp^Vhcr, Rb, Rb^Dr, Rb^Dr, Re^Es, Re^Es, Rb^Dr, Chr^Edt, Rb, Rb^Dr, Rr, Rr^Es, Rr, Rr^Es, Rr^Es, Rb^Dr, Rb^Dr, Rb^Dr, Rb^Es, Rb^Dr, Rb^Es, Rb^Dr, Rb^Dr, Rr, Re, Rb^Dr, Rb^Dr, Rb^Dr, Rr, Rb^Dr, Rb^Dr, Re, Ch^Qhux, Rb^Gvs, Gs^Eff, Gs^Eff, Gs^Fds, Ww, Wo, Ww, Ww, Ww
Rb^Gvs, Rb^Gvs, Rb^Gvs, Rb^Gvs, Rb^Gvs, Re^Vhr, Gs^Eff, Gs^Eff, Gg, Gg, Gg, Gg, Gg, Ch^Qhux, Xos, Rb^Dr, Rb^Dr, Rb^Dr, Rr, Rr, Rr, Rb^Dr, Chr, Re^Es, Rb^Dr, Re^Es, Re^Es, Rb^Dr, Rr, Rr, Rb^Dr, Rr, Rr, Rr^Es, Rb^Dr, Rr, Rr, Rb^Dr, Rr^Vhc, Rb, Rb^Dr, Chr, Rr, Rr, Rb^Dr, Rb^Es, Rb^Dr, Rb^Dr, Rr, Re, Re, Re, Ch^Qhux, Gs, Gll^Fp, Gs^Fds, Gg^Efm, Ww, Wo, Wo, Gs^Fms, Gg
Rb^Gvs, Rb^Gvs, Rb^Gvs, Rb^Gvs, Rb^Gvs, Rb^Gvs, Rb^Gvs, Gs^Eff, Gs^Eff, Gg, Gg, Gg, Gg, Gg, Gg, Rr^Pr\, Rr^Pr\, Rr, Rb^Dr, Rp^Vhcr, Rb, Rr, Rr, Rb^Dr, Rp^Vhcr, Rb^Dr, Rr, Rr, Ch, Rb^Dr, Rp^Vhcr, Rb, Rr, Rb^Dr, Rp^Vhcr, Rb^Dr, Chr, Rr, Rr, Rb^Dr, Chr, Chr, Rr, Rb^Dr, Rb^Es, Rb^Es, Rp^Vhhr, Rr, Rp^Vhr, Rb^Dr, Ch^Qhux, Ch^Qhux, Gs^Fds, Gll^Fp, Gll^Fp, Gs^Fds, Gg^Efm, Ww, Gs^Fds, Ww, Gs^Fds, Gs^Fds
Rb^Gvs, Rb^Gvs, Rb^Gvs, Rb^Gvs, Rb^Gvs, Rb^Gvs, Rb^Gvs, Rb^Gvs, Rb^Gvs, Gs^Eff, Gs^Eff, Gg, Gg, Gg, Rr, Rr, Gg, Rr^Pr\, Xos, Rb^Dr, Rb, Rb^Dr, Rp^Vhcr, Rr, Rr, Rr, Ch, Ch, Rb^Dr, Rb^Es, Rb^Dr, Rb^Dr, Rr, Chr, Rb^Dr, Rb^Dr, Rb^Dr, Rb, Rb^Dr, Rr, Rr, Rr, Chr^Edt, Rb^Dr, Rb^Es, Rb^Es, Rb^Dr, Rr, Rb^Dr, Rb^Dr, Ch^Qhux, Gs^Fds, Gs^Fms, Gs^Fms, Gs^Eff, Gs^Eff, Gs^Eff, Gs^Eff, Gs^Eff, Gs^Fds, Gll^Fms, Gs^Fms
Rb^Gvs, Rb^Gvs, Rb^Gvs, Rb^Gvs, Rb^Gvs, Rb^Gvs, Rb^Gvs, Rb^Gvs, Rb^Gvs, Rb^Gvs, Gs^Eff, Gg^Eff, Rr, Rr, Gg, Gg, Gg, Gg, Gg, Ch^Qhux, Ch^Qhux, Rb, Rb^Dr, Rb, Rb^Dr, Rr, Rr, Ch, Ch, Rb^Es, Rb^Es, Rb, Rb^Dr, Chr, Re^Es, Rr^Es, Rb^Es, Rp^Vhcr, Rr^Dr, Rr, Ch, Rr, Rr, Chr^Edt, Rb^Dr, Rb^Dr, Chr, Re^Es, Re^Es, Rb^Dr, Ch^Qhux, Gs^Fds, Gs^Eff, Gs^Eff, Rb^Gvs, Rb^Gvs, Rb^Gvs, Rb^Gvs, Rb^Gvs, Gs^Eff, Gs^Fds, Gs^Fds
Rb^Gvs, Rb^Gvs, Re^Vct, Rb^Gvs, Re^Vct, Re^Ecf, Rb^Gvs, Rb^Gvs, Gs^Eff, Gs^Eff, Rr, Rr, Gg, Re, Gs^Vh, Gs^Fds, Gs^Fds, Gg, Gg, Gg, Gg, Ch^Qhux, Ch^Qhux, Rb, Rb, Rp^Vhr, Rr, Rb^Dr, Rb, Rb^Dr, Rb, Rb^Dr, Rr, Re^Es, Rb^Dr, Rr^Es, Rr^Es, Rb^Dr, Rr, Rb^Dr, Rb^Dr, Ch, Rb^Dr, Rr, Rr, Rb^Dr, Rp^Vhcr, Rb^Dr, Re^Es, Rb^Dr, Ch^Qhux, Gs^Fds, Rb^Gvs, Rb^Gvs, Rb^Gvs, Rb^Gvs, Rb^Gvs, Rb^Gvs, Gs^Wm, Gs^Fds, Gs^Fds, Gs^Fds
Rb^Gvs, Rb^Gvs, Re, Re^Edt, Re^Edt, Re^Vct, Gs^Eff, Gs^Eff, Rr, Rr, Gg, Gg, Gs, Gg, Gg, Gg, Gs^Fms, Gs^Fds, Gg, Gg, Ch^Qhux, Ch^Qhux, Rb^Dr, Rb^Dr, Ce^Edt, Rp, Rb^Dr, Rp^Vc, Rb, Re^Es, Re^Es, Rp^Vhr, Rr^Es, Rp^Vhcr, Rr, Rb^Dr, Rr, Rr^Es, Rr, Rb^Dr, Rb^Dr, Rb^Dr, Rb^Es, Re, Chr, Rr, Rr, Rb^Dr, Rb^Dr, Re^Es, Xos, Gg, Rb^Gvs, Rb^Gvs, Rb^Gvs, Rb^Gvs, Re, Re, Rb^Gvs, Gs, Rb^Gvs, Gs^Fds
Rb^Gvs, Rb^Gvs, Co, Co, Co^Edt, Gs, Rr, Rr, Gg, Gg, Gg, Gs, Gs^Fms, Gs^Fms, Gs^Fds, Gg, Gs^Fms, Gg, Ch^Qhux, Ch^Qhux, Rb^Dr, Re, Rp^Vhr, Rb^Dr, Ce^Edt, Rp, Rb^Dr, Rb^Dr, Ce, Rb^Dr, Rb^Dr, Re^Es, Rr^Es, Rr, Rb^Dr, Rr, Rb^Dr, Rb^Dr, Chr^Edt, Rr, Rr, Rp^Vhcr, Rb^Es, Rb^Dr, Rb^Dr, Re, Rb^Dr, Rr, Rr^Pr/, Rr^Pr/, Gg, Gg, Re, Re^Vhr, Re, Re, Rb^Gvs, Rb^Gvs, Rb^Gvs, Rb^Gvs, Rb^Gvs, Rb^Gvs
Rb^Gvs, Rb^Gvs, Gs, Co, Co^Edt, Rr, Re^Edt, Re^Vct, Re^Ecf, Gg, Gg, Gs^Fds, Re, Gs^Fds, Re, Gs^Fds, Ch^Qhux, Ch^Qhux, Rb, Rb, Re, Re, Rp, Rp, Rp, Rp, Rp, Rp, Rp, Rb^Dr, Rp^Vc, Ce, Rr, Rb^Dr, Re^Es, Rr, Rb^Dr, Ch, Chr^Edt, Rb^Dr, Rr, Rb^Dr, Rr, Rb^Es, Rb^Dr, Re, Xos, Rr^Pr/, Gg, Rr, Rr, Gg, Re, Re, Rb^Gvs, Rb^Gvs, Rb^Gvs, Rb^Gvs, Rb^Gvs, Rb^Gvs, Rb^Gvs, Rb^Gvs
Gs, Gs, Rr, 4 Ko, Co^Edt, Co^Edt, Re^Edt, Re^Vct, Gg, Gg, Re^Eff, Re^Eff, Rb^Gvs, Re, Rb^Gvs, Ch^Qhux, Ch^Qhux, Rb, Rb^Dr, Rp^Vhr, Rb, Rp, Ce, Ce, Re, Rp^Vh, Ce^Edt, Ce, Ce, Rp, Rb^Dr, Ce, Rr, Rb^Dr, Re^Es, Re^Es, Rr, Ch, Rb^Es, Rb^Dr, Rp^Vhr, Rr, Re, Rb^Dr, Ch^Qhux, Ch^Qhux, Gg, Gg, Gg, Gg, Re^Eff, Rr, Rr, Re^Eff, Re^Eff, Rb^Gvs, Rb^Gvs, Rb^Gvs, Rb^Gvs, Rb^Gvs, Rb^Gvs, Rb^Gvs
Rr, Rr, Re^Edt, Re^Edt, Co^Edt, Co^Edt, Gg, Gg, Re^Eff, Re^Eff, Rb^Gvs, Rb^Gvs, Rb^Gvs, Rb^Gvs, Rb^Gvs, Rb^Gvs, Rb^Gvs, Ch^Qhux, Ch^Qhux, Rb^Dr, Rb, Ce, Rb^Dr, Re, Rb^Dr, Re, Rb, Ce^Edt, Ce, Rp, Rp, Ce, Rr, Chr, Chr, Rp^Vhr, Rb^Dr, Rr^Es, Rb^Es, Rb^Dr, Rb^Dr, Re^Es, Ch^Qhux, Ch^Qhux, Re, Re, Re^Eff, Re^Eff, Re^Eff, Re^Eff, Rb^Gvs, Re^Eff, Re^Eff, Rr, Rr, Re^Eff, Re^Eff, Rb^Gvs, Rb^Gvs, Rb^Gvs, Rb^Gvs, Rb^Gvs
Gs, Gs, Re^Vct, Re^Edt, Gg, Re^Edt, Re^Vct, Gs, Re, Re^Eff, Gs^Fds, Rb^Gvs, Rb^Gvs, Rb^Gvs, Rb^Gvs, Rb^Gvs, Rb^Gvs, Rb^Gvs, Rb^Gvs, Ch^Qhux, Ch^Qhux, Rb, Ch^Qhux, Ch^Qhux, Ch^Qhux, Rb^Dr, Rb, Rb^Dr, Rp^Vhr, Re, Rb^Dr, Rp, Rr, Rb^Dr, Rb^Dr, Rb^Dr, Ce, Rr, Rb^Dr, Rb^Dr, Ch^Qhux, Ch^Qhux, Re, Re, Re^Eff, Re^Eff, Rb^Gvs, Rb^Gvs, Rb^Gvs, Rb^Gvs, Rb^Gvs, Rb^Gvs, Re, Re^Eff, Re, Rr, Rr, Re^Eff, Re, Rb^Gvs, Rb^Gvs, Rb^Gvs
Gg, Gs, Re^Ecf, Re^Vct, Gs^Fms, Gg, Gs, Gs^Fms, Gs^Fms, Gs^Fds, Rb^Gvs, Rb^Gvs, Rb^Gvs, Rb^Gvs, Rb^Gvs, Rb^Gvs, Rb^Gvs, Rb^Gvs, Rb^Gvs, Gs^Fds, Gs^Fds, Ch^Qhux, Gs^Fms, Gs^Fds, Gs^Fds, Ch^Qhux, Ch^Qhux, Rb^Dr, Rb^Dr, Re, Ce, Rb^Dr, Rr, Rp^Vhcr, Rb, Ce, Rb^Es, Rb, Ch^Qhux, Ch^Qhux, Re, Re, Re^Eff, Re^Eff, Rb^Gvs, Rb^Gvs, Rb^Gvs, Rb^Gvs, Rb^Gvs, Rb^Gvs, Re, Re, Rb^Gvs, Re^Vhr, Rb^Gvs, Re^Eff, Re^Eff, Rr, Rr, Re^Eff, Re^Eff, Rb^Gvs
Gg, Gg, Gg, Gs^Fms, Gs^Fms, Gg, Re, Gs^Fds, Gs^Fds, Gs^Fds, Rb^Gvs, Rb^Gvs, Re^Eff, Re^Eff, Re^Eff, Rb^Gvs, Gs^Fds, Rb^Gvs, Rb^Gvs, Gs^Fms, Rb^Gvs, Gs^Fds, Rb^Gvs, Rb^Gvs, Rb^Gvs, Gs^Fds, Gs^Fms, Ch^Qhux, Ch^Qhux, Rb^Dr, Rb^Dr, Rb^Dr, Rr, Rb^Dr, Rb^Dr, Rb^Es, Ch^Qhux, Ch^Qhux, Gs^Fds, Re, Rb^Gvs, Re^Eff, Re^Eff, Rb^Gvs, Rb^Gvs, Rb^Gvs, Rb^Gvs, Rb^Gvs, Re, Re, Rb^Gvs, Rb^Gvs, Rb^Gvs, Rb^Gvs, Re^Vct, Re^Vct, Re^Edt, Re, Ce, Rr, Rr, Re^Eff
Gs^Fds, Gg, Gs^Fds, Gg, Gg, Gs, Re, Re, Re^Eff, Rb^Gvs, Re^Eff, Re^Eff, Re^Vhr, Re, Re, Re^Eff, Re^Eff, Gs^Fds, Rb^Gvs, Rb^Gvs, Rb^Gvs, Rb^Gvs, Rb^Gvs, Rb^Gvs, Rb^Gvs, Rb^Gvs, Rb^Gvs, Gs^Fms, Gs^Fds, Ch^Qhux, Isa, Ch, Ch, Ch, Isa^Es, Ch^Qhux, Gs^Fds, Gs^Fds, Gs^Fms, Rb^Gvs, Rb^Gvs, Rb^Gvs, Rb^Gvs, Re^Eff, Re^Eff, Re^Vhr, Re, Re, Rb^Gvs, Rb^Gvs, Rb^Gvs, Rb^Gvs, Re^Vct, Re^Ecf, Re, Re^Edt, Ce, Ce, Ce, Ce, Re^Eff, Rr
Gs^Fds, Gs^Fds, Gs^Fms, Gs^Fds, Rb^Gvs, Gs, Rb^Gvs, Re, Re, Re^Eff, Re, Re, Re^Eff, Re^Eff, Re^Eff, Re, Re, Re^Eff, Re^Wm, Rb^Gvs, Rb^Gvs, Rb^Gvs, Rb^Gvs, Rb^Gvs, Rb^Gvs, Rb^Gvs, Rb^Gvs, Rb^Gvs, Rb^Gvs, Ch^Qhux, Isa, Ch, 5 Kh, Ch, Isa, Ch^Qhux, Gs^Fds, Gs^Fds, Rb^Gvs, Rb^Gvs, Rb^Gvs, Rb^Gvs, Rb^Gvs, Rb^Gvs, Re, Re, Re^Eff, Rb^Gvs, Rb^Gvs, Rb^Gvs, Rb^Gvs, Re^Vct, Re^Edt, Re, Ce, Ce, Ce, 3 Ke, Re, Re, Re^Vct, Re^Eff
Gs^Fds, Gs^Fms, Gs^Fds, Gs^Fds, Rb^Gvs, Rb^Gvs, Rb^Gvs, Rb^Gvs, Re, Re, Re^Eff, Re^Eff, Rb^Gvs, Rb^Gvs, Rb^Gvs, Re^Eff, Re^Eff, Re, Re, Rb^Gvs, Rb^Gvs, Rb^Gvs, Rb^Gvs, Rb^Gvs, Rb^Gvs, Rb^Gvs, Rb^Gvs, Rb^Gvs, Rb^Gvs, Ch^Qhux, Isa, Ch, Ch, Ch, Isa, Ch^Qhux, Gs^Fds, Gs^Fms, Rb^Gvs, Rb^Gvs, Rb^Gvs, Rb^Gvs, Rb^Gvs, Rb^Gvs, Re, Gs^Fds, Gs^Fds, Re^Eff, Re^Eff, Rb^Gvs, Rb^Gvs, Re^Ecf, Re^Vct, Re^Edt, Re, Ce, Re^Edt, Re, Re^Ecf, Re^Vct, Gs^Fds, Gs^Fds
Gs^Fds, Gs^Fds, Gs, Gs^Fms, Gs, Rb^Gvs, Re, Re, Re^Eff, Re^Eff, Rb^Gvs, Rb^Gvs, Rb^Gvs, Rb^Gvs, Rb^Gvs, Rb^Gvs, Rb^Gvs, Re^Eff, Re, Rb^Gvs, Rb^Gvs, Rb^Gvs, Rb^Gvs, Rb^Gvs, Rb^Gvs, Rb^Gvs, Rb^Gvs, Rb^Gvs, Rb^Gvs, Ch^Qhux, Ch^Qhux, Isa, Isa, Isa, Ch^Qhux, Ch^Qhux, Gs^Fms, Rb^Gvs, Rb^Gvs, Rb^Gvs, Rb^Gvs, Rb^Gvs, Re, Re, Rb^Gvs, Rb^Gvs, Rb^Gvs, Gs^Fds, Gs^Fds, Re^Eff, Re^Eff, Rb^Gvs, Rb^Gvs, Re^Vct, Rb^Gvs, Re, Re^Vct, Re^Vct, Gs^Fds, Rb^Gvs, Rb^Gvs, Rb^Gvs
Gll^Fp, Gg, Gs, Gs, Rb^Gvs, Rb^Gvs, Re, Re^Eff, Rb^Gvs, Rb^Gvs, Rb^Gvs, Rb^Gvs, Rb^Gvs, Rb^Gvs, Re, Rb^Gvs, Rb^Gvs, Rb^Gvs, Re, Gs^Fds, Rb^Gvs, Rb^Gvs, Rb^Gvs, Rb^Gvs, Rb^Gvs, Rb^Gvs, Rb^Gvs, Rb^Gvs, Rb^Gvs, Rb^Gvs, Rb^Gvs, Ch^Qhux, Ch^Qhux, Ch^Qhux, Rb^Gvs, Rb^Gvs, Re^Eff, Rb^Gvs, Rb^Gvs, Rb^Gvs, Re, Re, Rb^Gvs, Re, Re, Rb^Gvs, Re^Vhr, Rb^Gvs, Re^Eff, Re^Eff, Rb^Gvs, Re^Eff, Re^Eff, Rb^Gvs, Rb^Gvs, Rb^Gvs, Gs^Fds, Gs^Fms, Gs^Fds, Rb^Gvs, Rb^Gvs, Rb^Gvs
Gg, Gg, Gs, Gs, Re^Eff, Re^Eff, Re^Vhr, Rb^Gvs, Rb^Gvs, Rb^Gvs, Rb^Gvs, Rb^Gvs, Re, Re, Rb^Gvs, Re, Re, Rb^Gvs, Re, Gs^Fms, Gs^Fds, Rb^Gvs, Rb^Gvs, Rb^Gvs, Rb^Gvs, Rb^Gvs, Rb^Gvs, Rb^Gvs, Rb^Gvs, Rb^Gvs, Rb^Gvs, Rb^Gvs, Rb^Gvs, Rb^Gvs, Rb^Gvs, Rb^Gvs, Rb^Gvs, Re^Eff, Re, Re, Rb^Gvs, Rb^Gvs, Rb^Gvs, Rb^Gvs, Rb^Gvs, Re, Re, Re^Eff, Rb^Gvs, Rb^Gvs, Rb^Gvs, Rb^Gvs, Rb^Gvs, Re, Re^Eff, Re^Vhr, Rb^Gvs, Rb^Gvs, Rb^Gvs, Rb^Gvs, Rb^Gvs, Rb^Gvs
Gs^Fds, Gg, Gg, Gg, Gg, Re^Eff, Re^Eff, Rb^Gvs, Rb^Gvs, Rb^Gvs, Re, Re, Rb^Gvs, Rb^Gvs, Rb^Gvs, Rb^Gvs, Rb^Gvs, Re, Re, Gs^Fds, Re, Gs^Fds, Rb^Gvs, Rb^Gvs, Rb^Gvs, Rb^Gvs, Rb^Gvs, Rb^Gvs, Rb^Gvs, Rb^Gvs, Rb^Gvs, Rb^Gvs, Rb^Gvs, Rb^Gvs, Rb^Gvs, Rb^Gvs, Re, Re, Rb^Gvs, Re^Eff, Re^Eff, Rb^Gvs, Rb^Gvs, Rb^Gvs, Re^Eff, Re^Eff, Rb^Gvs, Re, Re, Rb^Gvs, Rb^Gvs, Rb^Gvs, Rb^Gvs, Rb^Gvs, Rb^Gvs, Re^Eff, Re^Eff, Rb^Gvs, Rb^Gvs, Rb^Gvs, Rb^Gvs, Rb^Gvs
Gs^Fds, Gs^Fds, Gs^Fds, Gg, Gg, Gs, Gs, Re^Eff, Re, Re, Rb^Gvs, Rb^Gvs, Rb^Gvs, Rb^Gvs, Rb^Gvs, Rb^Gvs, Rb^Gvs, Rb^Gvs, Rb^Gvs, Re^Vhr, Rb^Gvs, Re, Re, Re, Re, Rb^Gvs, Re, Re, Re, Rb^Gvs, Rb^Gvs, Rb^Gvs, Gs^Fds, Gs^Fds, Rb^Gvs, Re, Rb^Gvs, Rb^Gvs, Rb^Gvs, Rb^Gvs, Rb^Gvs, Re^Wm, Gs^Fds, Re^Eff, Rb^Gvs, Rb^Gvs, Rb^Gvs, Rb^Gvs, Rb^Gvs, Re, Re, Rb^Gvs, Rb^Gvs, Rb^Gvs, Re^Eff, Re^Eff, Rb^Gvs, Re^Eff, Re^Eff, Rb^Gvs, Rb^Gvs, Rb^Gvs
Gll^Fp, Gll^Fp, Gg, Gg, Gg, Gg, Gs, Re, Gs, Re^Eff, Re^Eff, Rb^Gvs, Rb^Gvs, Rb^Gvs, Rb^Gvs, Rb^Gvs, Rb^Gvs, Rb^Gvs, Rb^Gvs, Rb^Gvs, Rb^Gvs, Rb^Gvs, Rb^Gvs, Rb^Gvs, Rb^Gvs, Re, Rb^Gvs, Rb^Gvs, Rb^Gvs, Re^Vhr, Re, Re, Re, Gs^Fds, Gs^Fds, Re, Rb^Gvs, Rb^Gvs, Rb^Gvs, Rb^Gvs, Rb^Gvs, Rb^Gvs, Rb^Gvs, Gs^Fms, Gs^Fds, Rb^Gvs, Rb^Gvs, Rb^Gvs, Rb^Gvs, Rb^Gvs, Rb^Gvs, Re, Re, Re^Eff, Rb^Gvs, Rb^Gvs, Rb^Gvs, Rb^Gvs, Rb^Gvs, Re, Re^Eff, Rb^Gvs
Gll^Fp, Gs^Fds, Gll, Gg, Gll, Gg, Gg, Gg, Gg, Gs, Gg, Re^Eff, Re^Eff, Rb^Gvs, Rb^Gvs, Gs^Fds, Gs^Fds, Gs, Gs, Rb^Gvs, Rb^Gvs, Rb^Gvs, Rb^Gvs, Rb^Gvs, Rb^Gvs, Rb^Gvs, Rb^Gvs, Rb^Gvs, Rb^Gvs, Rb^Gvs, Rb^Gvs, Rb^Gvs, Rb^Gvs, Re, Re, Re, Re^Vhr, Rb^Gvs, Rb^Gvs, Rb^Gvs, Rb^Gvs, Rb^Gvs, Rb^Gvs, Rb^Gvs, Rb^Gvs, Gs^Fds, Gs^Fms, Rb^Gvs, Rb^Gvs, Rb^Gvs, Re^Eff, Re^Eff, Rb^Gvs, Re^Vhr, Re, Rb^Gvs, Rb^Gvs, Rb^Gvs, Rb^Gvs, Rb^Gvs, Rb^Gvs, Re^Eff
Gll^Fp, Gll^Fp, Gll^Em, Gll, Gll, Gll^Fp, Gll^Fp, Gg, Gs^Fms, Gg, Gll, Gg, Gg, Re^Eff, Re^Eff, Gs^Fds, Gs^Fds, Gs, Gs, Gs, Rb^Gvs, Rb^Gvs, Rb^Gvs, Rb^Gvs, Rb^Gvs, Rb^Gvs, Rb^Gvs, Rb^Gvs, Rb^Gvs, Rb^Gvs, Rb^Gvs, Rb^Gvs, Rb^Gvs, Gs^Fds, Gs^Fds, Re, Rb^Gvs, Rb^Gvs, Rb^Gvs, Rb^Gvs, Rb^Gvs, Rb^Gvs, Rb^Gvs, Rb^Gvs, Rb^Gvs, Rb^Gvs, Rb^Gvs, Gs^Fds, Re^Eff, Re^Eff, Rb^Gvs, Rb^Gvs, Rb^Gvs, Rb^Gvs, Re, Rb^Gvs, Rb^Gvs, Rb^Gvs, Rb^Gvs, Rb^Gvs, Rb^Gvs, Rb^Gvs
Gll^Fp, Gll^Em, Gll, Gll^Em, Gs^Fms, Gll^Fp, Gll^Fp, Gs^Fms, Gll^Em, Gll, Gll, Gg, Gs^Fms, Gll, Gll^Fp, Gll^Fp, Gs^Fms, Gs^Fds, Gll, Gs, Gs^Fds, Gs^Fds, Rb^Gvs, Rb^Gvs, Rb^Gvs, Rb^Gvs, Rb^Gvs, Rb^Gvs, Rb^Gvs, Rb^Gvs, Rb^Gvs, Rb^Gvs, Rb^Gvs, Rb^Gvs, Gs^Fds, Re, Rb^Gvs, Rb^Gvs, Rb^Gvs, Rb^Gvs, Rb^Gvs, Rb^Gvs, Rb^Gvs, Rb^Gvs, Rb^Gvs, Rb^Gvs, Re^Eff, Re^Eff, Rb^Gvs, Rb^Gvs, Rb^Gvs, Rb^Gvs, Rb^Gvs, Rb^Gvs, Re, Rb^Gvs, Rb^Gvs, Rb^Gvs, Rb^Gvs, Rb^Gvs, Rb^Gvs, Rb^Gvs
Gll^Fp, Gll^Fp, Gll^Fp, Gll^Fp, Gs^Fms, Gll^Fp, Gs^Fms, Gs^Fms, Gs^Fms, Gs^Fms, Gg, Gll, Gs^Fms, Gs^Fms, Gs^Fms, Gll^Fp, Gs^Fms, Gll, Gll, Gll, Gll^Fds, Gs^Fds, Rb^Gvs, Rb^Gvs, Rb^Gvs, Rb^Gvs, Rb^Gvs, Rb^Gvs, Rb^Gvs, Rb^Gvs, Rb^Gvs, Rb^Gvs, Rb, Rb^Gvs, Gs^Fds, Re, Rb^Gvs, Rb^Gvs, Rb^Gvs, Rb^Gvs, Rb^Gvs, Rb^Gvs, Rb^Gvs, Rb^Gvs, Re^Eff, Re^Eff, Rb^Gvs, Rb^Gvs, Rb^Gvs, Rb^Gvs, Rb^Gvs, Rb^Gvs, Rb^Gvs, Rb^Gvs, Re, Rb^Gvs, Rb^Gvs, Rb^Gvs, Rb^Gvs, Rb^Gvs, Rb^Gvs, Rb^Gvs
