Gd, Gg, Hhd, Hhd, Hhd, Hhd, Hhd, Hhd, Hhd, Hhd, Hhd, Hhd, Hhd^Fdf, Hhd, Hhd^Fdf, Hhd, Hhd, Hhd, Hhd, Hhd, Hhd, Hhd, Hhd, Hhd, Hhd^Fdf, Gg, Hhd^Fdf, Hhd^Fdf, Hhd^Fdf, Gg^Fds, Hhd^Fdf, Hhd, Hhd, Hhd, Hhd, Hhd, Hhd, Hhd, Hhd, Hhd, Hhd, Gs, Gs, Gs, Gs, Gs, Gs, Gs, Gs, Gg^Edt, Rr, Gs, Gs, Re^Edt, Gs, Gll^Fdf, Gll^Fmf, Gll^Fms, Gll^Fdf, Gll^Fdf, Gll^Fdf, Gll^Fdf
Gd, Hhd, Gd, Hhd, Gd, Hhd, Hhd, Hhd, Hhd, Hhd, Hhd, Gs, Gs, Hhd^Fdf, Hhd^Fdf, Hhd^Fdf, Gd, Hhd, Hhd, Hhd, Hhd, Hhd^Fdf, Hhd, Hhd^Fdf, Hhd, Hhd^Fdf, Hhd^Fdf, Hhd^Fdf, Hhd^Fdf, Hhd^Fdf, Gd, Hhd, Hhd, Hhd, Gs, Hhd, Gs, Hhd, Gs, Hhd, Gs, Gs, Gs, Gs, Gs, Gs, Re^Vct, Gs, Gd, Gs, Rr, Gs, Re^Vct, Gs, Gll^Fmf, Gll^Fdf, Gll^Fmf, Gll^Fdf, Gll^Fdf, Gll^Fdf, Gll^Fdf, Gll^Fdf
Gd, Gd, Gd, Gd, Gd, Gd, Gd, Gs, Gs, Hhd, Gs, Hhd, Gs, Gs, Gs, Hhd, Gs, Gd, Gd, Hhd, Gd, Gd, Hhd, Hhd, Hhd, Hhd, Hhd, Hhd^Fmf, Gd, Hhd, Hhd, Gd, Gd, Gs, Gs, Gs, Gll^Fdf, Gs, Gll^Fdf, Gs, Gll^Fdf, Gs, Gs, Gs, Re, Re^Vct, Re^Ecf, Re, Re^Vct, Gs, Rr, Re, Gd, Gd, Gll^Fmf, Gll^Fdf, Gs, Gs, Gll^Fdf, Gll^Fdf, Gll^Fdf, Gll^Fdf
Gs^Fdf, Hhd, Gs^Fdf, Hhd, Gs, Gs, Gs^Fdf, Gs, Gs, Gs, Gs, Gs, Gs, Gs, Gd, Gs, Gs, Gs, Hhd^Fdf, Gd, Hhd^Fdf, Gd, Hhd, Hhd, Hhd, Hhd, Gd, Hhd, Hhd, Hhd, Re, Gd, Re, Gd, Gs, Gs, Gs, Gll^Fmf, Gll^Fmf, Gll^Fdf, Gs, Gll^Fdf, Gs, Re^Vct, Re^Vct, Re, Re, Re^Vct, Rr, Rr, Ce, Ce, 2 Ke, Gd, Gs, Gs, Gs, Gs^Vl, Gll^Fdf, Gll^Fdf, Gll^Fdf, Gll^Fdf
Gll^Fdf, Gs^Fdf, Gll^Fdf, Hhd, Gs, Gs^Fdf, Gll^Fdf, Hhd^Fdf, Hhd, Hhd, Gs, Gs, Gd, Gd, Gd, Gd, Gs, Gs, Hhd, Hhd^Fdf, Hhd, Hhd, Hhd, Hhd, Hhd, Gd, Gd, Hhd, Re, Re, Rb^Gvs, Re, Re^Vhr, Re, Gs, Gs, Gs, Gll^Fmf, Gs, Gs^Vl, Gs, Gs, Gs, Gd, Gd, Re^Vct, Rr, Rr, Re, Ce, Re^Ecf, Ce, Ce, Ce, Re, Gs, Gll^Fdf, Gll^Fdf, Gll^Fmf, Gll^Fdf, Gll^Fdf, Gll^Fdf
Gs, Gs, Gs, Gs, Hhd, Hhd^Fdf, Hhd^Fdf, Hhd^Fdf, Hhd, Gs, Gs, Gd, Gs, Gd, Gs, Gs, Re^Eff, Re, Re, Re, Re, Re, Re, Re, Re, Re, Re, Re, Rb^Gvs, Rb^Gvs, Rb^Gvs, Rb^Gvs, Rb^Gvs, Re, Re, Gs, Gs, Gs, Gs, Gs, Gs, Gs, Gs, Gs, Rr, Rr, Re, Re^Vct, Re^Vct, Re, Re, Ce, Gs, Gs, Re^Vct, Re^Vct, Gll^Fdf, Gll^Fdf, Gll^Fdf, Gll^Fmf, Rb^Gvs, Gll^Fdf
Re, Re, Re, Re, Re, Gd, Gd, Hhd, Gd, Hhd, Gs, Gs, Gd, Gd, Re^Eff, Re^Eff, Rb^Gvs, Rb^Gvs, Rb^Gvs, Rb^Gvs, Rb^Gvs, Rb^Gvs, Ch^Qhux, Re, Rb^Gvs, Rb^Gvs, Rb^Gvs, Rb^Gvs, Rb^Gvs, Rb^Gvs, Rb^Gvs, Rb^Gvs, Rb^Gvs, Rb^Gvs, Ch^Qhux, Re, Re, Gs, Gs, Gs, Gs, Gs, Rr, Rr, Gd^Eff, Gd^Eff, Gd^Eff, Gs, Gs, Gs, Gs, Re, Re, Gs, Gs, Gs, Gd^Eff, Gll^Fmf, Rb^Gvs, Rb^Gvs, Rb^Gvs, Rb^Gvs
Gs, Gs, Hhd, Gs, Gs, Re, Re, Gd, Re, Hhd, Hhd, Gd, Re^Eff, Re^Vhr, Rb^Gvs, Rb^Gvs, Rb^Gvs, Rb^Gvs, Rb^Gvs, Rb^Gvs, Chr^Qhux, Ch^Qhux, Rb, Ch^Qhux, Ch^Qhux, Rb^Gvs, Rb^Gvs, Rb^Gvs, Rb^Gvs, Rb^Gvs, Rb^Gvs, Rb^Gvs, Ch^Qhux, Ch^Qhux, Rb, Ch^Qhux, Xos, Re, Re, Gs, Rr, Rr, Gd^Eff, Gd^Eff, Rb^Gvs, Rb^Gvs, Rb^Gvs, Gd^Eff, Gd^Eff, Gd^Eff, Gd^Eff, Gs, Gs, Re, Re, Gd^Eff, Rb^Gvs, Rb^Gvs, Rb^Gvs, Rb^Gvs, Rb^Gvs, Rb^Gvs
Hhd, Hhd, Hhd^Fdf, Gd, Hhd, Gs, Gs, Re, Gs, Re, Re, Re^Eff, Rb^Gvs, Rb^Gvs, Rb^Gvs, Rb^Gvs, Rb^Gvs, Rb^Gvs, Ch^Qhux, Ch^Qhux, Rb, Rb, Rb^Vhr, Rb, Rb, Ch^Qhux, Chr^Qhux, Rb^Gvs, Rb^Gvs, Rb^Gvs, Ch^Qhux, Ch^Qhux, Re, Rb, Re, Rb, Rb^Dr, Rr^Pr\, Rr^Pr\, Rr, Gs, Gd^Eff, Rb^Gvs, Rb^Gvs, Rb^Gvs, Rb^Gvs, Rb^Gvs, Rb^Gvs, Rb^Gvs, Rb^Gvs, Rb^Gvs, Gd^Eff, Gd^Eff, Gd^Eff, Rb^Gvs, Re, Re, Rb^Gvs, Rb^Gvs, Rb^Gvs, Rb^Gvs, Rb^Gvs
Hhd, Hhd^Fdf, Hhd^Fdf, Hhd, Hhd, Gd, Gd, Gs, Gs^Eff, Gs^Eff, Re, Re, Rb^Gvs, Rb^Gvs, Rb^Gvs, Rb^Gvs, Ch^Qhux, Chr^Qhux, Rb, Rb, Re, Rb, Rb^Vhr, Rb, Chr, Rb, Rb, Ch^Qhux, Ch^Qhux, Ch^Qhux, Rb, Rb, Rb, Re, Chr, Re^Vhcr, Rr, Rr, Rb, Rr^Pr\, Xos, Rb^Gvs, Rb^Gvs, Rb^Gvs, Rb^Gvs, Rb^Gvs, Rb^Gvs, Rb^Gvs, Rb^Gvs, Rb^Gvs, Rb^Gvs, Rb^Gvs, Rb^Gvs, Rb^Gvs, Rb^Gvs, Rb^Gvs, Rb^Gvs, Re^Vhr, Rb^Gvs, Rb^Gvs, Rb^Gvs, Rb^Gvs
Hhd, Hhd, Gd, Hhd, Gd, Gd, Gd, Re^Vhr, Rb^Gvs, Rb^Gvs, Rb^Gvs, Re, Re, Rb^Gvs, Ch^Qhux, Ch^Qhux, Isa, Isa, Isa, Isa, Isa, Re, Re^Es, Rb^Es, Rb, Rb^Dr, Re^Es, Rb, Rb, Rb, Chr, Rb, Chr, Re, Rr, Rr, Re^Es, Rb^Dr, Re, Rb, Rb, Ch^Qhux, Ch^Qhux, Rb^Gvs, Rb^Gvs, Rb^Gvs, Ch^Qhux, Ch^Qhux, Ch^Qhux, Rb^Gvs, Rb^Gvs, Rb^Gvs, Rb^Gvs, Rb^Gvs, Gll^Fdf, Rb^Gvs, Rb^Gvs, Re, Rb^Gvs, Rb^Gvs, Rb^Gvs, Rb^Gvs
Gs, Gs, Gs, Gd, Gll^Fmf, Gd, Gll^Fdf, Rb^Gvs, Rb^Gvs, Rb^Gvs, Rb^Gvs, Rb^Gvs, Re, Chr^Qhux, Isa, Isa, Kh, Ch, Ch, Ch, Isa, Rb^Dr, Re^Es, Rb^Dr, Rr^Vhcr, Re, Rr, Chr, Rb^Dr, Rb^Vhhr, Rb^Dr, Chr, Rr, Rr, Rb^Dr, Rr^Vhc, Re^Es, Re^Es, Rr, Rr^Vhcr, Re, Rb, Rb, Chr^Qhux, Chr^Qhux, Ch^Qhux, Rb, Rb, Rb, Ch^Qhux, Ch^Qhux, Rb^Gvs, Rb^Gvs, Gll^Fdf, Rb^Gvs, Rb^Gvs, Rb^Gvs, Re^Edt, Rb^Gvs, Rb^Gvs, Gll^Fdf, Gll^Fdf
Gs, Gs, Gll^Fdf, Gll^Fdf, Gll^Fdf, Gll^Fdf, Gll^Fdf, Rb^Gvs, Rb^Gvs, Rb^Gvs, Rb^Gvs, Rb^Gvs, Gs, Chr^Qhux, Isa, Kh, 7 Kh, Kh, Ch, Isa, Isa, Rb^Dr, Rr^Vhcr, Re, Rr, Rr, Re, Rr, Rb^Dr, Rb^Dr, Rr, Rr, Rr, Rr, Rr, Rb^Dr, Chr, Rb^Dr, Rr, Rb^Dr, Re, Rb, Rb^Vhr, Rb, Re, Re, Ch, Ch, Ch, Rb, Ch^Qhux, Rb^Gvs, Rb^Gvs, Rb^Gvs, Rb^Gvs, Rb^Gvs, Rb^Gvs, Re, Gll^Fdf, Gs^Fms, Gll^Fdf, Gll^Fdf
Gs, Gs, Gs, Gll^Fmf, Gll^Fdf, Gll^Fmf, Rb^Gvs, Rb^Gvs, Rb^Gvs, Rb^Gvs, Rb^Gvs, Rb^Gvs, Gs, Ch^Qhux, Isa, Kh, Kh, Ch, Ch, Ch, Isa, Isa, Rr, Rr, Chr, Rb^Dr, Re, Rb^Dr, Rr^Vhcr, Rr, Rb^Dr, Rr^Vhcr, Rr, Rb^Dr, Rb^Dr, Rr, Rr, Rr, Rb^Dr, Rb^Dr, Chr, Re, Rb^Es, Rb^Es, Rb^Dr, Re, Ch, 6 Kh, Chr, Isa, Ch^Qhux, Rb^Gvs, Rb^Gvs, Rb^Gvs, Rb^Gvs, Rb^Gvs, Rb^Gvs, Re, Gd^Efm, Gll^Fdf, Gs^Fms, Gs^Fms
Gs, Gs, Gs, Hhd, Hhd, Hhd, Hhd, Rb^Gvs, Hhd, Rb^Gvs, Gll^Fdf, Gs, Gs, Ch^Qhux, Rb, Isa, Ch, Ch, Ch, Isa^Qhh, Isa, Rr, Rb^Dr, Rb^Dr, Rb^Dr, Rb, Chr, Rb, Rb^Dr, Rb, Rb, Rb^Dr, Rr, Rb^Es, Rb^Dr, Rb^Vhcr, Rr, Rb, Rb, Rb^Es, Rb^Es, Rb^Dr, Rr^Vhc, Rb^Dr, Rr, Ch, Isa, Chr, Isa, Isa, Chr^Qhux, Rb^Gvs, Rb^Gvs, Rb^Gvs, Rb^Gvs, Rb^Gvs, Rb^Gvs, Re^Vhr, Gll^Fdf, Gll^Fdf, Rb^Gvs, Rb^Gvs
Gll^Fdf, Gll^Fdf, Hhd, Hhd, Hhd, Hhd^Fdf, Hhd, Hhd, Gs, Gll^Fmf, Gs, Gs, Ch^Qhux, Chr^Qhux, Rb^Dr, Isa, Ch, Isa, Isa, Isa, Rb^Dr, Rr, Rr, Chr, Re, Re, Chr, Khr, Chr, Rb^Dr, Rb, Chr, Rr, Chr, Rb, Rr, Chr, Chr, Rb, Rb^Es, Rb^Es, Rb^Dr, Rr, Rr, Rb^Es, Re^Es, Re^Wm, Re, Rb^Vhr, Rb, Chr^Qhux, Rb^Gvs, Rb^Gvs, Rb^Gvs, Rb^Gvs, Rb^Gvs, Rb^Gvs, Re, Rb^Gvs, Rb^Gvs, Rb^Gvs, Rb^Gvs
Gs, Gll^Fdf, Gs, Hhd, Gll^Fdf, Hhd, Gll^Fdf, Hhd, Rb^Gvs, Gs, Gs, Ch^Qhux, Re, Re, Re, Isa, Isa, Isa, Rb^Dr, Rr^Vhcr, Rb^Dr, Rr^Vhcr, Rr, Rb^Dr, Rr, Rr^Vhcr, Rb^Dr, Rb^Es, Rb^Es, Rb^Dr, Rb^Dr, Chr, Rr, Chr, Rb^Dr, Rr, Khr, Chr, Rb, Rr^Vhcr, Rr, Rr, Chr, Chr, Rb^Es, Re^Es, Rb, Re, Re, Rb, Chr^Qhux, Rb^Gvs, Rb^Gvs, Rb^Gvs, Rb^Gvs, Rb^Gvs, Rb^Gvs, Re^Edt, Re^Edt, Rb^Gvs, Rb^Gvs, Rb^Gvs
Gs, Gs, Gs, Gs, Gs, Gs, Gs, Gll^Fdf, Rb^Gvs, Rb^Gvs, Rb^Gvs, Ch^Qhux, Re, Rb, Rb^Dr, Re, Rb^Dr, Rb, Rp^Vhcr, Rb^Dr, Rr, Rr, Rb^Vhhr, Rb^Dr, Rb, Rb^Dr, Rr, Rb^Es, Re, Rb^Es, Rb^Vhcr, Rb, Rr, Rb^Dr, Rb^Vhc, Rb, Rb^Dr, Rb^Dr, Rr, Rb^Dr, Rb^Dr, Rb^Dr, Chr, Rb^Es, Rb^Dr, Rb^Dr, Rr, Rr, Chr, Re, Rb, Chr^Qhux, Ch^Qhux, Rb^Gvs, Rb^Gvs, Rb^Gvs, Rb^Gvs, Rb^Gvs, Rb^Gvs, Re, Rb^Gvs, Rb^Gvs
Rb^Gvs, Rb^Gvs, Rb^Gvs, Rb^Gvs, Rb^Gvs, Re, Gll^Fdf, Gs, Rb^Gvs, Rb^Gvs, Rb^Gvs, Chr^Qhux, Rb, Rb^Vhr, Rb, Rb, Rb^Dr, Rb, Rb^Dr, Rr, Chr, Rb^Dr, Rb^Dr, Rb^Es, Rb, Rb^Dr, Isa^Es, Rr, Rr, Re, Rb^Dr, Rb^Dr, Rr, Rb^Dr, Rb, Rb, Rr, Rr, Re, Rb^Dr, Rb^Dr, Rr, Rb, Rb^Dr, Rb^Dr, Rb, Rr, Chr, Chr, Re, Rb^Wm, Rb, Ch^Qhux, Rb^Gvs, Rb^Gvs, Rb^Gvs, Rb^Gvs, Rb^Gvs, Rb^Gvs, Re, Re, Gs
Rb^Gvs, Rb^Gvs, Rb^Gvs, Rb^Gvs, Rb^Gvs, Gll^Fdf, Gll^Fdf, Rb^Gvs, Rb^Gvs, Rb^Gvs, Rb^Gvs, Chr^Qhux, Rb^Dr, Rb, Rb, Chr, Chr, Rb^Dr, Rp^Vhcr, Rb^Dr, Rb^Dr, Rb, Rb^Es, Rb^Es, Chr, Chr, Rb^Dr, Rb^Dr, Rb, Rr, Rr, Chr, Rr, Chr, Rr, Rr, Rb^Dr, Rb^Dr, Chr, Re, Re, Rr, Rr, Rr^Vhcr, Rr, Rr, Rb^Dr, Rr, Rr, Rb, Rb, Rb, Ch^Qhux, Rb^Gvs, Rb^Gvs, Rb^Gvs, Rb^Gvs, Rb^Gvs, Gd^Eff, Gd^Eff, Re, Gs
Rb^Gvs, Rb^Gvs, Rb^Gvs, Rb^Gvs, Rb^Gvs, Rb^Gvs, Rb^Gvs, Rb^Gvs, Rb^Gvs, Rb^Gvs, Re, Ch^Qhux, Rb, Rb^Vhr, Rb, Khr, Rb^Es, Rb^Dr, Re^Es, Rr, Rb^Dr, Rb, Rb, Rb^Dr, Chr, Khr, Re, Chr, Rb^Vhcr, Rb^Dr, Chr, Rr, 1 Rr, Rr, Chr, Rb, Rb^Vhcr, Rb^Dr, Rb^Dr, Rb^Dr, Re^Vhcr, Rb^Dr, Re, Rr, Chr, Rb, Khr, Rb^Es, Rb^Dr, Rb^Vhr, Rb, Rb, Ch^Qhux, Rb^Gvs, Rb^Gvs, Rb^Gvs, Gll^Fdf, Gll^Fdf, Gll^Fdf, Gll^Fdf, Ww, Gs
Rb^Gvs, Rb^Gvs, Rb^Gvs, Rb^Gvs, Rb^Gvs, Rb^Gvs, Rb^Gvs, Rb^Gvs, Gd^Eff, Gd^Eff, Gs, Ch^Qhux, Ch^Qhux, Rb, Rb^Dr, Chr, Rb^Dr, Re^Es, Re^Es, Rr, Rr^Vhcr, Rb, Rb^Dr, Rb^Dr, Re, Re, Rb^Dr, Chr, Rb, Rb^Dr, Rr, Rr, Rr, Rr, Rr, Rb^Dr, Rb^Dr, Rb^Dr, Rb, Rb^Dr, Rb, Re, Rb^Dr, Rr, Chr, Rb^Dr, Rb^Es, Rb^Es, Rr, Rb^Dr, Rb^Vc, Rb, Ch^Qhux, Rb^Gvs, Gd^Eff, Gd^Eff, Gll^Fdf, Ww, Wo, Ww, Ww, Ww
Rb^Gvs, Rb^Gvs, Rb^Gvs, Rb^Gvs, Rb^Gvs, Re^Vhr, Gd^Eff, Gd^Eff, Gs, Gs, Gs, Gs, Gs, Ch^Qhux, Xos, Rb, Re, Re, Rr, Rr, Rr, Rb, Chr, Re, Rb^Dr, Re, Re, Rb^Dr, Rr, Rr, Rb^Dr, Chr, Rr, Chr, Rb^Dr, Rr, Rr, Rb, Rr^Vhc, Re, Re, Chr, Rr, Rr, Rb^Dr, Rb, Rb^Dr, Rb^Dr, Rr, Rb, Rb, Rb, Ch^Qhux, Gs, Gll^Fp, Gll^Fdf, Gs^Efm, Ww, Wo, Wo, Gll^Fmf, Gd
Rb^Gvs, Rb^Gvs, Rb^Gvs, Rb^Gvs, Rb^Gvs, Rb^Gvs, Rb^Gvs, Gd^Eff, Gd^Eff, Gs, Gs, Gs, Gs, Gs, Gs, Rr^Pr\, Rr^Pr\, Rr, Rb^Dr, Rr^Vhcr, Rb, Rr, Rr, Rb^Dr, Rr^Vhcr, Rb^Dr, Rr, Rr, Chr, Rb^Dr, Rb^Vhcr, Rb, Rr, Rb^Dr, Rb^Vhcr, Rb^Dr, Chr, Rr, Rr, Rb^Dr, Chr, Chr, Rr, Rb^Vhcr, Rb, Rb^Es, Rr^Vhhr, Rr, Rb^Vhr, Rb^Dr, Chr^Qhux, Ch^Qhux, Gll^Fdf, Gll^Fp, Gll^Fp, Gll^Fdf, Gs^Efm, Ww, Gll^Fdf, Ww, Gll^Fdf, Gll^Fdf
Rb^Gvs, Rb^Gvs, Rb^Gvs, Rb^Gvs, Rb^Gvs, Rb^Gvs, Rb^Gvs, Rb^Gvs, Rb^Gvs, Gd^Eff, Gd^Eff, Gs, Gs, Gs, Rr, Rr, Gs, Rr^Pr\, Xos, Rb^Dr, Rb, Rb^Dr, Rr^Vhcr, Rr, Rr, Rr, Chr, Chr, Rb^Dr, Rb, Rb^Dr, Rb^Dr, Rr, Rb, Rb, Rb^Dr, Rb^Dr, Rb, Rb^Dr, Rr, Rr, Rr, Chr, Rb^Dr, Rb^Es, Rb^Es, Rb^Dr, Rr, Rb^Dr, Rb, Ch^Qhux, Gll^Fdf, Gll^Fmf, Gll^Fmf, Gd^Eff, Gd^Eff, Gd^Eff, Gd^Eff, Gd^Eff, Gll^Fdf, Gll^Fmf, Gll^Fmf
Rb^Gvs, Rb^Gvs, Rb^Gvs, Rb^Gvs, Rb^Gvs, Rb^Gvs, Rb^Gvs, Rb^Gvs, Rb^Gvs, Rb^Gvs, Gd^Eff, Gd^Eff, Rr, Rr, Gs, Gs, Gs, Gs, Gs, Ch^Qhux, Chr^Qhux, Rb, Rb^Dr, Rb^Es, Rb^Dr, Rr, Rr, Chr, Chr, Re, Re^Es, Rb^Es, Rb^Dr, Chr, Khr, Chr, Rb, Rb^Vhcr, Rr^Dr, Rr, Chr, Rr, Rr, Chr, Rb^Dr, Rb^Dr, Chr, Rb^Es, Rb^Es, Rb^Es, Ch^Qhux, Gll^Fdf, Gd^Eff, Gd^Eff, Rb^Gvs, Rb^Gvs, Rb^Gvs, Rb^Gvs, Rb^Gvs, Gd^Eff, Gll^Fdf, Gll^Fdf
Rb^Gvs, Rb^Gvs, Re^Vct, Rb^Gvs, Re^Vct, Re^Ecf, Rb^Gvs, Rb^Gvs, Gd^Eff, Gd^Eff, Rr, Rr, Gs, Re, Gs^Vh, Gll^Fdf, Gll^Fdf, Gs, Gs, Gs, Gs, Ch^Qhux, Ch^Qhux, Rb^Es, Rb^Es, Rb^Vhr, Rr, Rb^Dr, Rb^Dr, Rb^Dr, Re^Es, Rb^Dr, Rr, Rb, Rb^Dr, Chr, Rr, Rb^Dr, Rr, Rb^Dr, Rb^Dr, Chr, Rb^Dr, Rr, Rr, Rb^Dr, Rr^Vhcr, Rb^Dr, Rb^Es, Rb^Dr, Ch^Qhux, Gll^Fdf, Rb^Gvs, Rb^Gvs, Rb^Gvs, Rb^Gvs, Rb^Gvs, Rb^Gvs, Gd^Wm, Gll^Fdf, Gll^Fdf, Gll^Fdf
Rb^Gvs, Rb^Gvs, Re, Re^Edt, Re^Edt, Re^Vct, Gd^Eff, Gd^Eff, Rr, Rr, Gs, Gs, Gs, Gs, Gs, Gs, Gll^Fmf, Gll^Fdf, Gs, Gs, Ch^Qhux, Ch^Qhux, Rb^Dr, Rb^Dr, Ce, Rr, Rb^Dr, Rb^Vc, Rb, Rb^Dr, Rb^Es, Rb^Vhr, Rr, Rr^Vhcr, Rr, Rb^Dr, Rr, Rr, Rr, Rb^Dr, Rb^Dr, Rb^Dr, Rb, Re, Chr, Rr, Rr, Rb^Dr, Rb^Dr, Rb^Es, Xos, Gs, Rb^Gvs, Rb^Gvs, Rb^Gvs, Rb^Gvs, Re, Re, Rb^Gvs, Gd, Rb^Gvs, Gll^Fdf
Rb^Gvs, Rb^Gvs, Co, Co, Co^Edt, Gs, Rr, Rr, Gs, Gs, Gs, Gs, Gll^Fmf, Gll^Fmf, Gll^Fdf, Gs, Gll^Fmf, Gs, Ch^Qhux, Ch^Qhux, Rb^Dr, Rb, Rb^Vhr, Rb^Dr, Ce, Rr, Rb^Dr, Rb^Dr, Ce, Rb^Es, Rb^Dr, Rb^Es, Rr, Rr, Rb^Dr, Rr, Rb^Es, Rb^Dr, Chr, Rr, Rr, Rp^Vhcr, Rb, Rb^Dr, Rb^Dr, Re, Rb^Dr, Rr, Rr^Pr/, Rr^Pr/, Gs, Gs, Re, Re^Vhr, Re, Re, Rb^Gvs, Rb^Gvs, Rb^Gvs, Rb^Gvs, Rb^Gvs, Rb^Gvs
Rb^Gvs, Rb^Gvs, Gs, Co, Co^Edt, Rr, Re^Edt, Re^Vct, Re^Ecf, Gs, Gs, Gll^Fdf, Re, Gll^Fdf, Re, Gll^Fdf, Ch^Qhux, Ch^Qhux, Rb, Rb, Rb, Rb, Rr, Rr, Rr, Rr, Rr, Rr, Rr, Rb^Dr, Rb^Vc, Ce, Rr, Rb^Es, Rb, Rr, Rb^Dr, Chr, Chr, Rb^Dr, Rr, Rb^Dr, Rr, Rb, Rb^Dr, Re, Xos, Rr^Pr/, Gs, Rr, Rr, Gs, Re, Re, Rb^Gvs, Rb^Gvs, Rb^Gvs, Rb^Gvs, Rb^Gvs, Rb^Gvs, Rb^Gvs, Rb^Gvs
Gs, Gs, Rr, 4 Ko, Co^Edt, Co^Edt, Re^Edt, Re^Vct, Gs, Gs, Re^Eff, Re^Eff, Rb^Gvs, Re, Rb^Gvs, Ch^Qhux, Ch^Qhux, Rb, Rb^Dr, Rb^Vhr, Rb, Rr, Ce, Ce, Re, Rb^Vh, Ce, Ce, Ce, Rr, Rb^Dr, Ce, Rr, Rb^Dr, Rb^Es, Rb, Rr, Chr, Re, Rb^Dr, Rb^Vhr, Rr, Rb, Rb^Dr, Chr^Qhux, Ch^Qhux, Gs, Gs, Gs, Gs, Re^Eff, Rr, Rr, Re^Eff, Re^Eff, Rb^Gvs, Rb^Gvs, Rb^Gvs, Rb^Gvs, Rb^Gvs, Rb^Gvs, Rb^Gvs
Rr, Rr, Re^Edt, Re^Edt, Co^Edt, Co^Edt, Gs, Gs, Re^Eff, Re^Eff, Rb^Gvs, Rb^Gvs, Rb^Gvs, Rb^Gvs, Rb^Gvs, Rb^Gvs, Rb^Gvs, Ch^Qhux, Ch^Qhux, Rb^Dr, Rb, Ce, Rb^Dr, Rb, Rb, Re, Re, Ce, Ce, Rr, Rr, Ce, Rr, Chr, Chr, Rp^Vhr, Rb^Dr, Rr, Rb, Re, Rb^Dr, Re, Ch^Qhux, Chr^Qhux, Re, Re, Re^Eff, Re^Eff, Re^Eff, Re^Eff, Rb^Gvs, Re^Eff, Re^Eff, Rr, Rr, Re^Eff, Re^Eff, Rb^Gvs, Rb^Gvs, Rb^Gvs, Rb^Gvs, Rb^Gvs
Gs, Gs, Re^Vct, Re^Edt, Gs, Re^Edt, Re^Vct, Gd, Re, Re^Eff, Gll^Fdf, Rb^Gvs, Rb^Gvs, Rb^Gvs, Rb^Gvs, Rb^Gvs, Rb^Gvs, Rb^Gvs, Rb^Gvs, Chr^Qhux, Ch^Qhux, Rb, Ch^Qhux, Chr^Qhux, Ch^Qhux, Rb^Dr, Rb, Rb^Dr, Rb^Vhr, Re, Rb^Dr, Rr, Rr, Rb^Dr, Rb^Dr, Rb, Ce, Rr, Rb^Dr, Re, Ch^Qhux, Ch^Qhux, Re, Re, Re^Eff, Re^Eff, Rb^Gvs, Rb^Gvs, Rb^Gvs, Rb^Gvs, Rb^Gvs, Rb^Gvs, Re, Re^Eff, Re, Rr, Rr, Re^Eff, Re, Rb^Gvs, Rb^Gvs, Rb^Gvs
Gs, Gs, Re^Ecf, Re^Vct, Gll^Fmf, Gs, Gs, Gll^Fmf, Gll^Fmf, Gll^Fdf, Rb^Gvs, Rb^Gvs, Rb^Gvs, Rb^Gvs, Rb^Gvs, Rb^Gvs, Rb^Gvs, Rb^Gvs, Rb^Gvs, Gll^Fdf, Gll^Fdf, Ch^Qhux, Gll^Fmf, Gll^Fdf, Gll^Fdf, Ch^Qhux, Ch^Qhux, Rb, Rb^Dr, Re, Ce, Rb^Dr, Rr, Rr^Vhcr, Re, Ce, Rb, Rb, Chr^Qhux, Ch^Qhux, Re, Re, Re^Eff, Re^Eff, Rb^Gvs, Rb^Gvs, Rb^Gvs, Rb^Gvs, Rb^Gvs, Rb^Gvs, Re, Re, Rb^Gvs, Re^Vhr, Rb^Gvs, Re^Eff, Re^Eff, Rr, Rr, Re^Eff, Re^Eff, Rb^Gvs
Gs, Gs, Gs, Gll^Fmf, Gll^Fmf, Gs, Re, Gll^Fdf, Gll^Fdf, Gll^Fdf, Rb^Gvs, Rb^Gvs, Re^Eff, Re^Eff, Re^Eff, Rb^Gvs, Gll^Fdf, Rb^Gvs, Rb^Gvs, Gll^Fmf, Rb^Gvs, Gll^Fdf, Rb^Gvs, Rb^Gvs, Rb^Gvs, Gll^Fdf, Gll^Fmf, Ch^Qhux, Ch^Qhux, Rb, Rb, Rb^Dr, Rr, Rb^Dr, Rb^Dr, Re, Ch^Qhux, Ch^Qhux, Gll^Fdf, Re, Rb^Gvs, Re^Eff, Re^Eff, Rb^Gvs, Rb^Gvs, Rb^Gvs, Rb^Gvs, Rb^Gvs, Re, Re, Rb^Gvs, Rb^Gvs, Rb^Gvs, Rb^Gvs, Re^Vct, Re^Vct, Re^Edt, Re, Ce, Rr, Rr, Re^Eff
Gll^Fdf, Gs, Gll^Fdf, Gs, Gs, Gd, Re, Re, Re^Eff, Rb^Gvs, Re^Eff, Re^Eff, Re^Vhr, Re, Re, Re^Eff, Re^Eff, Gll^Fdf, Rb^Gvs, Rb^Gvs, Rb^Gvs, Rb^Gvs, Rb^Gvs, Rb^Gvs, Rb^Gvs, Rb^Gvs, Rb^Gvs, Gll^Fmf, Gll^Fdf, Ch^Qhux, Isa, Ch, Ch, Ch, Isa^Es, Ch^Qhux, Gll^Fdf, Gll^Fdf, Gll^Fmf, Rb^Gvs, Rb^Gvs, Rb^Gvs, Rb^Gvs, Re^Eff, Re^Eff, Re^Vhr, Re, Re, Rb^Gvs, Rb^Gvs, Rb^Gvs, Rb^Gvs, Re^Vct, Re^Ecf, Re, Re^Edt, Ce, Ce, Ce, Ce, Re^Eff, Rr
Gll^Fdf, Gll^Fdf, Gll^Fmf, Gll^Fdf, Rb^Gvs, Gd, Rb^Gvs, Re, Re, Re^Eff, Re, Re, Re^Eff, Re^Eff, Re^Eff, Re, Re, Re^Eff, Re^Wm, Rb^Gvs, Rb^Gvs, Rb^Gvs, Rb^Gvs, Rb^Gvs, Rb^Gvs, Rb^Gvs, Rb^Gvs, Rb^Gvs, Rb^Gvs, Ch^Qhux, Isa, Ch, 5 Kh, Ch, Isa, Ch^Qhux, Gll^Fdf, Gll^Fdf, Rb^Gvs, Rb^Gvs, Rb^Gvs, Rb^Gvs, Rb^Gvs, Rb^Gvs, Re, Re, Re^Eff, Rb^Gvs, Rb^Gvs, Rb^Gvs, Rb^Gvs, Re^Vct, Re^Edt, Re, Ce, Ce, Ce, 3 Ke, Re, Re, Re^Vct, Re^Eff
Gll^Fdf, Gll^Fmf, Gll^Fdf, Gll^Fdf, Rb^Gvs, Rb^Gvs, Rb^Gvs, Rb^Gvs, Re, Re, Re^Eff, Re^Eff, Rb^Gvs, Rb^Gvs, Rb^Gvs, Re^Eff, Re^Eff, Re, Re, Rb^Gvs, Rb^Gvs, Rb^Gvs, Rb^Gvs, Rb^Gvs, Rb^Gvs, Rb^Gvs, Rb^Gvs, Rb^Gvs, Rb^Gvs, Ch^Qhux, Isa, Ch, Ch, Ch, Isa, Ch^Qhux, Gll^Fdf, Gll^Fmf, Rb^Gvs, Rb^Gvs, Rb^Gvs, Rb^Gvs, Rb^Gvs, Rb^Gvs, Re, Gll^Fdf, Gll^Fdf, Re^Eff, Re^Eff, Rb^Gvs, Rb^Gvs, Re^Ecf, Re^Vct, Re^Edt, Re, Ce, Re^Edt, Re, Re^Ecf, Re^Vct, Gll^Fdf, Gll^Fdf
Gll^Fdf, Gll^Fdf, Gd, Gll^Fmf, Gd, Rb^Gvs, Re, Re, Re^Eff, Re^Eff, Rb^Gvs, Rb^Gvs, Rb^Gvs, Rb^Gvs, Rb^Gvs, Rb^Gvs, Rb^Gvs, Re^Eff, Re, Rb^Gvs, Rb^Gvs, Rb^Gvs, Rb^Gvs, Rb^Gvs, Rb^Gvs, Rb^Gvs, Rb^Gvs, Rb^Gvs, Rb^Gvs, Chr^Qhux, Chr^Qhux, Isa, Isa, Isa, Ch^Qhux, Ch^Qhux, Gll^Fmf, Rb^Gvs, Rb^Gvs, Rb^Gvs, Rb^Gvs, Rb^Gvs, Re, Re, Rb^Gvs, Rb^Gvs, Rb^Gvs, Gll^Fdf, Gll^Fdf, Re^Eff, Re^Eff, Rb^Gvs, Rb^Gvs, Re^Vct, Rb^Gvs, Re, Re^Vct, Re^Vct, Gll^Fdf, Rb^Gvs, Rb^Gvs, Rb^Gvs
Gll^Fmf, Gs, Gd, Gd, Rb^Gvs, Rb^Gvs, Re, Re^Eff, Rb^Gvs, Rb^Gvs, Rb^Gvs, Rb^Gvs, Rb^Gvs, Rb^Gvs, Re, Rb^Gvs, Rb^Gvs, Rb^Gvs, Re, Gll^Fdf, Rb^Gvs, Rb^Gvs, Rb^Gvs, Rb^Gvs, Rb^Gvs, Rb^Gvs, Rb^Gvs, Rb^Gvs, Rb^Gvs, Rb^Gvs, Rb^Gvs, Ch^Qhux, Ch^Qhux, Chr^Qhux, Rb^Gvs, Rb^Gvs, Re^Eff, Rb^Gvs, Rb^Gvs, Rb^Gvs, Re, Re, Rb^Gvs, Re, Re, Rb^Gvs, Re^Vhr, Rb^Gvs, Re^Eff, Re^Eff, Rb^Gvs, Re^Eff, Re^Eff, Rb^Gvs, Rb^Gvs, Rb^Gvs, Gll^Fdf, Gll^Fmf, Gll^Fdf, Rb^Gvs, Rb^Gvs, Rb^Gvs
Gs, Gs, Gd, Gd, Re^Eff, Re^Eff, Re^Vhr, Rb^Gvs, Rb^Gvs, Rb^Gvs, Rb^Gvs, Rb^Gvs, Re, Re, Rb^Gvs, Re, Re, Rb^Gvs, Re, Gll^Fdf, Gll^Fdf, Rb^Gvs, Rb^Gvs, Rb^Gvs, Rb^Gvs, Rb^Gvs, Rb^Gvs, Rb^Gvs, Rb^Gvs, Rb^Gvs, Rb^Gvs, Rb^Gvs, Rb^Gvs, Rb^Gvs, Rb^Gvs, Rb^Gvs, Rb^Gvs, Re^Eff, Re, Re, Rb^Gvs, Rb^Gvs, Rb^Gvs, Rb^Gvs, Rb^Gvs, Re, Re, Re^Eff, Rb^Gvs, Rb^Gvs, Rb^Gvs, Rb^Gvs, Rb^Gvs, Re, Re^Eff, Re^Vhr, Rb^Gvs, Rb^Gvs, Rb^Gvs, Rb^Gvs, Rb^Gvs, Rb^Gvs
Gll^Fdf, Gs, Gs, Gs, Gs, Re^Eff, Re^Eff, Rb^Gvs, Rb^Gvs, Rb^Gvs, Re, Re, Rb^Gvs, Rb^Gvs, Rb^Gvs, Rb^Gvs, Rb^Gvs, Re, Re, Gll^Fdf, Re, Gll^Fdf, Rb^Gvs, Rb^Gvs, Rb^Gvs, Rb^Gvs, Rb^Gvs, Rb^Gvs, Rb^Gvs, Rb^Gvs, Rb^Gvs, Rb^Gvs, Rb^Gvs, Rb^Gvs, Rb^Gvs, Rb^Gvs, Re, Re, Rb^Gvs, Re^Eff, Re^Eff, Rb^Gvs, Rb^Gvs, Rb^Gvs, Re^Eff, Re^Eff, Rb^Gvs, Re, Re, Rb^Gvs, Rb^Gvs, Rb^Gvs, Rb^Gvs, Rb^Gvs, Rb^Gvs, Re^Eff, Re^Eff, Rb^Gvs, Rb^Gvs, Rb^Gvs, Rb^Gvs, Rb^Gvs
Gll^Fdf, Gll^Fdf, Gll^Fdf, Gs, Gs, Gd, Gd, Re^Eff, Re, Re, Rb^Gvs, Rb^Gvs, Rb^Gvs, Rb^Gvs, Rb^Gvs, Rb^Gvs, Rb^Gvs, Rb^Gvs, Rb^Gvs, Re^Vhr, Rb^Gvs, Re, Re, Re, Re, Rb^Gvs, Re, Re, Re, Rb^Gvs, Rb^Gvs, Rb^Gvs, Gll^Fdf, Gll^Fdf, Rb^Gvs, Re, Rb^Gvs, Rb^Gvs, Rb^Gvs, Rb^Gvs, Rb^Gvs, Re^Wm, Gll^Fdf, Re^Eff, Rb^Gvs, Rb^Gvs, Rb^Gvs, Rb^Gvs, Rb^Gvs, Re, Re, Rb^Gvs, Rb^Gvs, Rb^Gvs, Re^Eff, Re^Eff, Rb^Gvs, Re^Eff, Re^Eff, Rb^Gvs, Rb^Gvs, Rb^Gvs
Gll^Fp, Gll^Fp, Gs, Gs, Gs, Gs, Gd, Re, Gd, Re^Eff, Re^Eff, Rb^Gvs, Rb^Gvs, Rb^Gvs, Rb^Gvs, Rb^Gvs, Rb^Gvs, Rb^Gvs, Rb^Gvs, Rb^Gvs, Rb^Gvs, Rb^Gvs, Rb^Gvs, Rb^Gvs, Rb^Gvs, Re, Rb^Gvs, Rb^Gvs, Rb^Gvs, Re^Vhr, Re, Re, Re, Gll^Fdf, Gll^Fdf, Re, Rb^Gvs, Rb^Gvs, Rb^Gvs, Rb^Gvs, Rb^Gvs, Rb^Gvs, Rb^Gvs, Gll^Fmf, Gll^Fdf, Rb^Gvs, Rb^Gvs, Rb^Gvs, Rb^Gvs, Rb^Gvs, Rb^Gvs, Re, Re, Re^Eff, Rb^Gvs, Rb^Gvs, Rb^Gvs, Rb^Gvs, Rb^Gvs, Re, Re^Eff, Rb^Gvs
Gll^Fp, Gll^Fdf, Gll, Gs, Gll, Gs, Gs, Gs, Gs, Gd, Gs, Re^Eff, Re^Eff, Rb^Gvs, Rb^Gvs, Gll^Fdf, Gll^Fdf, Gd, Gd, Rb^Gvs, Rb^Gvs, Rb^Gvs, Rb^Gvs, Rb^Gvs, Rb^Gvs, Rb^Gvs, Rb^Gvs, Rb^Gvs, Rb^Gvs, Rb^Gvs, Rb^Gvs, Rb^Gvs, Rb^Gvs, Re, Re, Re, Re^Vhr, Rb^Gvs, Rb^Gvs, Rb^Gvs, Rb^Gvs, Rb^Gvs, Rb^Gvs, Rb^Gvs, Rb^Gvs, Gll^Fdf, Gll^Fmf, Rb^Gvs, Rb^Gvs, Rb^Gvs, Re^Eff, Re^Eff, Rb^Gvs, Re^Vhr, Re, Rb^Gvs, Rb^Gvs, Rb^Gvs, Rb^Gvs, Rb^Gvs, Rb^Gvs, Re^Eff
Gll^Fp, Gll^Fp, Gll^Em, Gll, Gll, Gll^Fp, Gll^Fp, Gs, Gll^Fmf, Gs, Gll, Gs, Gs, Re^Eff, Re^Eff, Gll^Fdf, Gll^Fdf, Gd, Gd, Gd, Rb^Gvs, Rb^Gvs, Rb^Gvs, Rb^Gvs, Rb^Gvs, Rb^Gvs, Rb^Gvs, Rb^Gvs, Rb^Gvs, Rb^Gvs, Rb^Gvs, Rb^Gvs, Rb^Gvs, Gll^Fdf, Gll^Fdf, Re, Rb^Gvs, Rb^Gvs, Rb^Gvs, Rb^Gvs, Rb^Gvs, Rb^Gvs, Rb^Gvs, Rb^Gvs, Rb^Gvs, Rb^Gvs, Rb^Gvs, Gll^Fdf, Re^Eff, Re^Eff, Rb^Gvs, Rb^Gvs, Rb^Gvs, Rb^Gvs, Re, Rb^Gvs, Rb^Gvs, Rb^Gvs, Rb^Gvs, Rb^Gvs, Rb^Gvs, Rb^Gvs
Gll^Fp, Gll^Em, Gll, Gll^Em, Gll^Fmf, Gll^Fp, Gll^Fp, Gll^Fmf, Gll^Em, Gll, Gll, Gs, Gll^Fmf, Gll, Gll^Fmf, Gll^Fmf, Gll^Fmf, Gll^Fdf, Gll, Gd, Gll^Fdf, Gll^Fdf, Rb^Gvs, Rb^Gvs, Rb^Gvs, Rb^Gvs, Rb^Gvs, Rb^Gvs, Rb^Gvs, Rb^Gvs, Rb^Gvs, Rb^Gvs, Rb^Gvs, Rb^Gvs, Gll^Fdf, Re, Rb^Gvs, Rb^Gvs, Rb^Gvs, Rb^Gvs, Rb^Gvs, Rb^Gvs, Rb^Gvs, Rb^Gvs, Rb^Gvs, Rb^Gvs, Re^Eff, Re^Eff, Rb^Gvs, Rb^Gvs, Rb^Gvs, Rb^Gvs, Rb^Gvs, Rb^Gvs, Re, Rb^Gvs, Rb^Gvs, Rb^Gvs, Rb^Gvs, Rb^Gvs, Rb^Gvs, Rb^Gvs
Gll^Fp, Gll^Fp, Gll^Fp, Gll^Fp, Gll^Fmf, Gll^Fp, Gll^Fmf, Gll^Fmf, Gll^Fmf, Gll^Fmf, Gg, Gll, Gll^Fmf, Gll^Fmf, Gll^Fmf, Gll^Fmf, Gll^Fmf, Gll, Gll, Gll, Gll^Fmf, Gll^Fdf, Rb^Gvs, Rb^Gvs, Rb^Gvs, Rb^Gvs, Rb^Gvs, Rb^Gvs, Rb^Gvs, Rb^Gvs, Rb^Gvs, Rb^Gvs, Rb, Rb^Gvs, Gll^Fdf, Re, Rb^Gvs, Rb^Gvs, Rb^Gvs, Rb^Gvs, Rb^Gvs, Rb^Gvs, Rb^Gvs, Rb^Gvs, Re^Eff, Re^Eff, Rb^Gvs, Rb^Gvs, Rb^Gvs, Rb^Gvs, Rb^Gvs, Rb^Gvs, Rb^Gvs, Rb^Gvs, Re, Rb^Gvs, Rb^Gvs, Rb^Gvs, Rb^Gvs, Rb^Gvs, Rb^Gvs, Rb^Gvs
